VILLCODE,COUNTYNAME,TOWNNAME,VILLNAME,election_zone,winner_name,winner_party,winner_votes,recall_agree_votes,recall_disagree_votes,compared_with,gap,recall_valid_votes,recall_eligible_voters,eligible_voters_election
65000170007,新北市,林口區,湖南里,新北市第01選區,洪孟楷,中國國民黨,9903,5464,7249,recall_disagree_votes,2654,12713,23660,22057
65000170008,新北市,林口區,南勢里,新北市第01選區,洪孟楷,中國國民黨,10140,6129,7681,recall_disagree_votes,2459,13810,25651,22995
65000060016,新北市,新店區,公崙里,新北市第11選區,羅明才,中國國民黨,5005,1829,3694,recall_disagree_votes,1311,5523,11676,11502
66000030012,臺中市,南區,樹義里,臺中市第06選區,羅廷瑋,中國國民黨,5225,3073,4163,recall_disagree_votes,1062,7236,12218,11636
66000170007,臺中市,潭子區,東寶里,臺中市第03選區,楊瓊瓔,中國國民黨,4564,2077,3523,recall_disagree_votes,1041,5600,11512,11693
65000100008,新北市,淡水區,崁頂里,新北市第01選區,洪孟楷,中國國民黨,8630,5357,7598,recall_disagree_votes,1032,12955,25881,20723
65000060060,新北市,新店區,香坡里,新北市第11選區,羅明才,中國國民黨,4604,1477,3632,recall_disagree_votes,972,5109,10546,10255
65000100012,新北市,淡水區,北投里,新北市第01選區,洪孟楷,中國國民黨,4078,2192,3112,recall_disagree_votes,966,5304,9791,9196
66000090027,臺中市,豐原區,北陽里,臺中市第08選區,江啟臣,中國國民黨,5095,2278,4142,recall_disagree_votes,953,6420,12696,12657
65000170016,新北市,林口區,麗林里,新北市第01選區,洪孟楷,中國國民黨,3454,1627,2508,recall_disagree_votes,946,4135,7606,7372
68000010050,桃園市,桃園區,同安里,桃園市第04選區,萬美玲,中國國民黨,3977,2440,3040,recall_disagree_votes,937,5480,9945,9892
66000170006,臺中市,潭子區,甘蔗里,臺中市第03選區,楊瓊瓔,中國國民黨,3817,1527,2895,recall_disagree_votes,922,4422,9236,9123
65000160017,新北市,泰山區,全興里,新北市第01選區,洪孟楷,中國國民黨,3004,1736,2084,recall_disagree_votes,920,3820,7707,7554
66000180002,臺中市,大雅區,員林里,臺中市第03選區,楊瓊瓔,中國國民黨,3896,1565,2980,recall_disagree_votes,916,4545,9109,8996
65000170003,新北市,林口區,西林里,新北市第01選區,洪孟楷,中國國民黨,3766,2303,2860,recall_disagree_votes,906,5163,9732,9530
66000170001,臺中市,潭子區,潭陽里,臺中市第03選區,楊瓊瓔,中國國民黨,4050,1772,3151,recall_disagree_votes,899,4923,10241,10338
65000100021,新北市,淡水區,竿蓁里,新北市第01選區,洪孟楷,中國國民黨,4252,2462,3355,recall_disagree_votes,897,5817,11094,10155
66000090019,臺中市,豐原區,社皮里,臺中市第08選區,江啟臣,中國國民黨,3933,1520,3040,recall_disagree_votes,893,4560,9485,9492
66000060005,臺中市,西屯區,惠來里,臺中市第04選區,廖偉翔,中國國民黨,5569,3636,4689,recall_disagree_votes,880,8325,15771,15203
66000030011,臺中市,南區,永興里,臺中市第06選區,羅廷瑋,中國國民黨,3442,2038,2603,recall_disagree_votes,839,4641,7928,7751
65000100035,新北市,淡水區,新春里,新北市第01選區,洪孟楷,中國國民黨,3353,1921,2527,recall_disagree_votes,826,4448,8519,8254
63000010012,臺北市,松山區,龍田里,臺北市第03選區,王鴻薇,中國國民黨,4017,1752,3209,recall_disagree_votes,808,4961,8211,8244
66000090025,臺中市,豐原區,南陽里,臺中市第08選區,江啟臣,中國國民黨,4030,1739,3240,recall_disagree_votes,790,4979,10183,10209
65000170015,新北市,林口區,仁愛里,新北市第01選區,洪孟楷,中國國民黨,2697,1308,1910,recall_disagree_votes,787,3218,5944,5886
68000010051,桃園市,桃園區,莊敬里,桃園市第04選區,萬美玲,中國國民黨,3715,1885,2944,recall_disagree_votes,771,4829,8711,8646
65000100042,新北市,淡水區,大庄里,新北市第01選區,洪孟楷,中國國民黨,4580,2445,3811,recall_disagree_votes,769,6256,11747,10325
65000060040,新北市,新店區,張北里,新北市第11選區,羅明才,中國國民黨,3506,1342,2757,recall_disagree_votes,749,4099,8095,8001
65000060014,新北市,新店區,柴埕里,新北市第11選區,羅明才,中國國民黨,3107,1237,2375,recall_disagree_votes,732,3612,7924,7844
63000020009,臺北市,信義區,安康里,臺北市第07選區,徐巧芯,中國國民黨,3295,2179,2568,recall_disagree_votes,727,4747,8213,8251
66000030021,臺中市,南區,工學里,臺中市第06選區,羅廷瑋,中國國民黨,3078,1672,2363,recall_disagree_votes,715,4035,6818,6559
66000090023,臺中市,豐原區,豐田里,臺中市第08選區,江啟臣,中國國民黨,3779,1742,3079,recall_disagree_votes,700,4821,9737,9857
66000170004,臺中市,潭子區,福仁里,臺中市第03選區,楊瓊瓔,中國國民黨,4195,1783,3497,recall_disagree_votes,698,5280,10832,10269
66000090016,臺中市,豐原區,西湳里,臺中市第08選區,江啟臣,中國國民黨,3422,1724,2725,recall_disagree_votes,697,4449,9168,9018
65000100010,新北市,淡水區,新興里,新北市第01選區,洪孟楷,中國國民黨,2731,1505,2038,recall_disagree_votes,693,3543,6593,6420
66000060018,臺中市,西屯區,永安里,臺中市第04選區,廖偉翔,中國國民黨,4487,2742,3809,recall_disagree_votes,678,6551,12407,12253
66000020016,臺中市,東區,東信里,臺中市第06選區,羅廷瑋,中國國民黨,3247,2510,2571,recall_disagree_votes,676,5081,8533,8569
63000010021,臺北市,松山區,自強里,臺北市第03選區,王鴻薇,中國國民黨,4010,1233,3335,recall_disagree_votes,675,4568,7273,7418
66000080013,臺中市,北屯區,廍子里,臺中市第05選區,黃健豪,中國國民黨,6910,4380,6237,recall_disagree_votes,673,10617,21138,17890
65000170009,新北市,林口區,東勢里,新北市第01選區,洪孟楷,中國國民黨,2602,1465,1937,recall_disagree_votes,665,3402,5975,6171
66000130016,臺中市,沙鹿區,埔子里,臺中市第02選區,顏寬恒,中國國民黨,2947,838,2295,recall_disagree_votes,652,3133,6026,5911
68000010074,桃園市,桃園區,寶安里,桃園市第04選區,萬美玲,中國國民黨,3267,1671,2623,recall_disagree_votes,644,4294,7865,7772
66000030019,臺中市,南區,南和里,臺中市第06選區,羅廷瑋,中國國民黨,2910,1671,2270,recall_disagree_votes,640,3941,7231,7155
65000100020,新北市,淡水區,八勢里,新北市第01選區,洪孟楷,中國國民黨,2641,1814,2003,recall_disagree_votes,638,3817,7300,6420
68000010004,桃園市,桃園區,大林里,桃園市第04選區,萬美玲,中國國民黨,2588,1592,1964,recall_disagree_votes,624,3556,6685,6684
66000130021,臺中市,沙鹿區,三鹿里,臺中市第02選區,顏寬恒,中國國民黨,3365,1146,2750,recall_disagree_votes,615,3896,8163,7386
66000080016,臺中市,北屯區,松竹里,臺中市第05選區,黃健豪,中國國民黨,3484,1987,2870,recall_disagree_votes,614,4857,8582,8661
65000060056,新北市,新店區,安和里,新北市第11選區,羅明才,中國國民黨,2738,1099,2124,recall_disagree_votes,614,3223,6844,6838
66000250016,臺中市,龍井區,東海里,臺中市第02選區,顏寬恒,中國國民黨,3280,1498,2674,recall_disagree_votes,606,4172,8557,8369
66000020017,臺中市,東區,東英里,臺中市第06選區,羅廷瑋,中國國民黨,2906,2032,2304,recall_disagree_votes,602,4336,7451,7363
65000060041,新北市,新店區,五峯里,新北市第11選區,羅明才,中國國民黨,2850,1163,2251,recall_disagree_votes,599,3414,6663,6761
68000010072,桃園市,桃園區,同德里,桃園市第04選區,萬美玲,中國國民黨,2605,1340,2009,recall_disagree_votes,596,3349,6020,5901
65000230001,新北市,八里區,龍源里,新北市第01選區,洪孟楷,中國國民黨,2744,1720,2150,recall_disagree_votes,594,3870,7086,6756
68000010061,桃園市,桃園區,自強里,桃園市第04選區,萬美玲,中國國民黨,3218,1738,2625,recall_disagree_votes,593,4363,7401,7332
65000100022,新北市,淡水區,鄧公里,新北市第01選區,洪孟楷,中國國民黨,2310,1310,1718,recall_disagree_votes,592,3028,5337,5314
66000180012,臺中市,大雅區,上雅里,臺中市第03選區,楊瓊瓔,中國國民黨,2344,988,1756,recall_disagree_votes,588,2744,5920,5894
68000010023,桃園市,桃園區,中山里,桃園市第04選區,萬美玲,中國國民黨,2678,1498,2090,recall_disagree_votes,588,3588,6378,6435
66000180009,臺中市,大雅區,上楓里,臺中市第03選區,楊瓊瓔,中國國民黨,2543,995,1957,recall_disagree_votes,586,2952,6246,6185
65000040062,新北市,永和區,保順里,新北市第09選區,林德福,中國國民黨,3688,1959,3102,recall_disagree_votes,586,5061,9087,8962
65000100017,新北市,淡水區,福德里,新北市第01選區,洪孟楷,中國國民黨,2734,1526,2154,recall_disagree_votes,580,3680,6376,6261
65000060058,新北市,新店區,寶福里,新北市第11選區,羅明才,中國國民黨,2808,1028,2236,recall_disagree_votes,572,3264,6265,6247
66000160005,臺中市,神岡區,社口里,臺中市第03選區,楊瓊瓔,中國國民黨,2883,1276,2311,recall_disagree_votes,572,3587,7411,7383
65000100011,新北市,淡水區,水碓里,新北市第01選區,洪孟楷,中國國民黨,1983,1250,1416,recall_disagree_votes,567,2666,4963,4994
68000010059,桃園市,桃園區,龍鳳里,桃園市第04選區,萬美玲,中國國民黨,3084,1591,2522,recall_disagree_votes,562,4113,9760,9545
63000010026,臺北市,松山區,中正里,臺北市第07選區,徐巧芯,中國國民黨,2582,2083,2021,recall_disagree_votes,561,4104,7125,7247
66000180013,臺中市,大雅區,文雅里,臺中市第03選區,楊瓊瓔,中國國民黨,2372,902,1812,recall_disagree_votes,560,2714,5675,5723
66000080009,臺中市,北屯區,軍功里,臺中市第05選區,黃健豪,中國國民黨,4421,3270,3863,recall_disagree_votes,558,7133,12267,12170
66000250011,臺中市,龍井區,龍泉里,臺中市第02選區,顏寬恒,中國國民黨,3172,1376,2617,recall_disagree_votes,555,3993,8526,7778
66000030013,臺中市,南區,樹德里,臺中市第06選區,羅廷瑋,中國國民黨,3720,2128,3169,recall_disagree_votes,551,5297,8738,8275
66000250013,臺中市,龍井區,新庄里,臺中市第02選區,顏寬恒,中國國民黨,2324,1023,1778,recall_disagree_votes,546,2801,6031,6032
65000100019,新北市,淡水區,民生里,新北市第01選區,洪孟楷,中國國民黨,2581,1606,2036,recall_disagree_votes,545,3642,6588,6434
65000060037,新北市,新店區,中興里,新北市第11選區,羅明才,中國國民黨,2328,834,1790,recall_disagree_votes,538,2624,6999,6861
65000160012,新北市,泰山區,義仁里,新北市第01選區,洪孟楷,中國國民黨,2916,2013,2380,recall_disagree_votes,536,4393,8469,7234
10015050001,花蓮縣,吉安鄉,北昌村,花蓮縣第01選區,傅崐萁,中國國民黨,2268,1435,1733,recall_disagree_votes,535,3168,5079,6420
66000170015,臺中市,潭子區,家興里,臺中市第03選區,楊瓊瓔,中國國民黨,2746,1182,2213,recall_disagree_votes,533,3395,6742,6626
68000010068,桃園市,桃園區,寶慶里,桃園市第04選區,萬美玲,中國國民黨,2575,1371,2044,recall_disagree_votes,531,3415,6096,6037
66000240014,臺中市,大肚區,頂街里,臺中市第02選區,顏寬恒,中國國民黨,2948,1230,2418,recall_disagree_votes,530,3648,7276,7149
65000110045,新北市,汐止區,福安里,新北市第12選區,廖先翔,中國國民黨,2170,1336,1640,recall_disagree_votes,530,2976,5463,5420
66000060038,臺中市,西屯區,福林里,臺中市第04選區,廖偉翔,中國國民黨,2987,1801,2460,recall_disagree_votes,527,4261,7830,7634
65000010124,新北市,板橋區,溪福里,新北市第07選區,葉元之,中國國民黨,3954,2857,3428,recall_disagree_votes,526,6285,11586,11622
66000180003,臺中市,大雅區,六寶里,臺中市第03選區,楊瓊瓔,中國國民黨,2461,833,1937,recall_disagree_votes,524,2770,5668,5718
65000060022,新北市,新店區,美潭里,新北市第11選區,羅明才,中國國民黨,1957,789,1434,recall_disagree_votes,523,2223,4540,4587
65000060017,新北市,新店區,德安里,新北市第11選區,羅明才,中國國民黨,2035,908,1513,recall_disagree_votes,522,2421,5048,5158
66000080008,臺中市,北屯區,水景里,臺中市第05選區,黃健豪,中國國民黨,4877,3489,4360,recall_disagree_votes,517,7849,13808,13320
65000060008,新北市,新店區,信義里,新北市第11選區,羅明才,中國國民黨,2393,1163,1878,recall_disagree_votes,515,3041,5854,5830
65000230006,新北市,八里區,舊城里,新北市第01選區,洪孟楷,中國國民黨,2351,1400,1836,recall_disagree_votes,515,3236,6309,6203
65000170005,新北市,林口區,中湖里,新北市第01選區,洪孟楷,中國國民黨,1699,1204,1185,recall_disagree_votes,514,2389,4668,4537
66000090022,臺中市,豐原區,田心里,臺中市第08選區,江啟臣,中國國民黨,2300,1005,1786,recall_disagree_votes,514,2791,6121,6056
66000180010,臺中市,大雅區,二和里,臺中市第03選區,楊瓊瓔,中國國民黨,2478,946,1965,recall_disagree_votes,513,2911,6004,5864
65000100018,新北市,淡水區,竹圍里,新北市第01選區,洪孟楷,中國國民黨,2354,1311,1847,recall_disagree_votes,507,3158,5577,5497
65000010065,新北市,板橋區,深丘里,新北市第07選區,葉元之,中國國民黨,2652,1796,2146,recall_disagree_votes,506,3942,6985,6886
66000080010,臺中市,北屯區,和平里,臺中市第05選區,黃健豪,中國國民黨,4189,2933,3683,recall_disagree_votes,506,6616,11897,11392
66000070024,臺中市,南屯區,三和里,臺中市第04選區,廖偉翔,中國國民黨,3409,2020,2904,recall_disagree_votes,505,4924,8554,8492
65000160003,新北市,泰山區,山腳里,新北市第01選區,洪孟楷,中國國民黨,2146,1351,1644,recall_disagree_votes,502,2995,5578,5649
65000060018,新北市,新店區,雙城里,新北市第11選區,羅明才,中國國民黨,2049,898,1547,recall_disagree_votes,502,2445,5134,5154
65000110014,新北市,汐止區,江北里,新北市第12選區,廖先翔,中國國民黨,1919,1477,1420,recall_disagree_votes,499,2897,5477,5321
63000040016,臺北市,中山區,永安里,臺北市第03選區,王鴻薇,中國國民黨,2833,2165,2335,recall_disagree_votes,498,4500,7499,7432
65000060044,新北市,新店區,中正里,新北市第11選區,羅明才,中國國民黨,2250,873,1754,recall_disagree_votes,496,2627,5049,5123
68000010075,桃園市,桃園區,瑞慶里,桃園市第04選區,萬美玲,中國國民黨,2375,1201,1879,recall_disagree_votes,496,3080,5756,5697
68000070028,桃園市,龜山區,大華里,桃園市第01選區,牛煦庭,中國國民黨,2959,2096,2464,recall_disagree_votes,495,4560,8532,8465
68000010071,桃園市,桃園區,龍壽里,桃園市第04選區,萬美玲,中國國民黨,2658,1425,2165,recall_disagree_votes,493,3590,6491,6365
68000010033,桃園市,桃園區,福林里,桃園市第04選區,萬美玲,中國國民黨,2314,1492,1822,recall_disagree_votes,492,3314,5687,5736
65000060019,新北市,新店區,日興里,新北市第11選區,羅明才,中國國民黨,1832,794,1340,recall_disagree_votes,492,2134,5077,5005
68000010030,桃園市,桃園區,中正里,桃園市第04選區,萬美玲,中國國民黨,2880,1795,2395,recall_disagree_votes,485,4190,7343,7176
66000160006,臺中市,神岡區,社南里,臺中市第03選區,楊瓊瓔,中國國民黨,1900,1003,1416,recall_disagree_votes,484,2419,4972,5039
66000160010,臺中市,神岡區,豐洲里,臺中市第03選區,楊瓊瓔,中國國民黨,2455,1320,1971,recall_disagree_votes,484,3291,6690,6861
66000090020,臺中市,豐原區,三村里,臺中市第08選區,江啟臣,中國國民黨,2392,1222,1909,recall_disagree_votes,483,3131,6031,6010
65000110030,新北市,汐止區,忠孝里,新北市第12選區,廖先翔,中國國民黨,2742,1625,2259,recall_disagree_votes,483,3884,7190,7049
63000010016,臺北市,松山區,民有里,臺北市第03選區,王鴻薇,中國國民黨,2657,2225,2175,recall_disagree_votes,482,4400,7068,7158
66000080020,臺中市,北屯區,后庄里,臺中市第05選區,黃健豪,中國國民黨,4028,2051,3547,recall_disagree_votes,481,5598,9658,9616
66000130014,臺中市,沙鹿區,六路里,臺中市第02選區,顏寬恒,中國國民黨,2173,1004,1692,recall_disagree_votes,481,2696,5600,5451
65000210005,新北市,三芝區,埔坪里,新北市第01選區,洪孟楷,中國國民黨,2370,1106,1892,recall_disagree_votes,478,2998,6072,5918
68000010049,桃園市,桃園區,中寧里,桃園市第04選區,萬美玲,中國國民黨,2480,1344,2003,recall_disagree_votes,477,3347,6229,6069
65000060057,新北市,新店區,吉祥里,新北市第11選區,羅明才,中國國民黨,2037,537,1561,recall_disagree_votes,476,2098,4103,4144
65000060020,新北市,新店區,玫瑰里,新北市第11選區,羅明才,中國國民黨,2261,742,1787,recall_disagree_votes,474,2529,5083,5127
66000090009,臺中市,豐原區,西安里,臺中市第08選區,江啟臣,中國國民黨,1894,880,1422,recall_disagree_votes,472,2302,4406,4600
65000110029,新北市,汐止區,厚德里,新北市第12選區,廖先翔,中國國民黨,2384,1350,1912,recall_disagree_votes,472,3262,6012,5962
66000150006,臺中市,后里區,墩東里,臺中市第03選區,楊瓊瓔,中國國民黨,2002,717,1530,recall_disagree_votes,472,2247,4516,4577
63000040014,臺北市,中山區,大直里,臺北市第03選區,王鴻薇,中國國民黨,2817,1828,2347,recall_disagree_votes,470,4175,6763,6965
68000010036,桃園市,桃園區,龍岡里,桃園市第04選區,萬美玲,中國國民黨,2417,1166,1951,recall_disagree_votes,466,3117,5529,5541
68000010032,桃園市,桃園區,雲林里,桃園市第04選區,萬美玲,中國國民黨,2388,1411,1923,recall_disagree_votes,465,3334,5658,5754
68000010048,桃園市,桃園區,信光里,桃園市第04選區,萬美玲,中國國民黨,2554,1683,2089,recall_disagree_votes,465,3772,6866,6750
66000080018,臺中市,北屯區,仁美里,臺中市第05選區,黃健豪,中國國民黨,3530,2380,3066,recall_disagree_votes,464,5446,9695,9312
63000010003,臺北市,松山區,東榮里,臺北市第03選區,王鴻薇,中國國民黨,2394,1934,1930,recall_disagree_votes,464,3864,6155,6286
66000180014,臺中市,大雅區,大楓里,臺中市第03選區,楊瓊瓔,中國國民黨,1915,793,1452,recall_disagree_votes,463,2245,4796,4828
66000170005,臺中市,潭子區,頭家里,臺中市第03選區,楊瓊瓔,中國國民黨,2153,807,1690,recall_disagree_votes,463,2497,5159,5157
66000030020,臺中市,南區,永和里,臺中市第06選區,羅廷瑋,中國國民黨,1883,1071,1423,recall_disagree_votes,460,2494,4560,4498
65000060067,新北市,新店區,永平里,新北市第11選區,羅明才,中國國民黨,1999,799,1539,recall_disagree_votes,460,2338,4753,4771
68000010041,桃園市,桃園區,豐林里,桃園市第04選區,萬美玲,中國國民黨,2373,1465,1914,recall_disagree_votes,459,3379,5774,5911
68000010055,桃園市,桃園區,中德里,桃園市第04選區,萬美玲,中國國民黨,2482,1438,2023,recall_disagree_votes,459,3461,6233,6234
63000020020,臺北市,信義區,國業里,臺北市第07選區,徐巧芯,中國國民黨,2334,1516,1876,recall_disagree_votes,458,3392,5681,5836
66000170014,臺中市,潭子區,頭家東里,臺中市第03選區,楊瓊瓔,中國國民黨,1747,664,1290,recall_disagree_votes,457,1954,4138,4159
63000010022,臺北市,松山區,吉祥里,臺北市第07選區,徐巧芯,中國國民黨,2595,1792,2138,recall_disagree_votes,457,3930,6422,6606
66000130009,臺中市,沙鹿區,竹林里,臺中市第02選區,顏寬恒,中國國民黨,2769,1210,2313,recall_disagree_votes,456,3523,7557,7513
63000010024,臺北市,松山區,新聚里,臺北市第07選區,徐巧芯,中國國民黨,2437,1787,1983,recall_disagree_votes,454,3770,6248,6416
63000020008,臺北市,信義區,廣居里,臺北市第07選區,徐巧芯,中國國民黨,2494,1513,2040,recall_disagree_votes,454,3553,5747,5952
68000010056,桃園市,桃園區,龍祥里,桃園市第04選區,萬美玲,中國國民黨,2129,911,1675,recall_disagree_votes,454,2586,4787,4821
68000010060,桃園市,桃園區,龍安里,桃園市第04選區,萬美玲,中國國民黨,2303,1161,1850,recall_disagree_votes,453,3011,5435,5357
66000030017,臺中市,南區,福順里,臺中市第06選區,羅廷瑋,中國國民黨,2294,1416,1847,recall_disagree_votes,447,3263,5656,5515
65000160010,新北市,泰山區,貴和里,新北市第01選區,洪孟楷,中國國民黨,1645,1005,1198,recall_disagree_votes,447,2203,4180,4240
10008020008,南投縣,埔里鎮,大城里,南投縣第01選區,馬文君,中國國民黨,2218,917,1772,recall_disagree_votes,446,2689,5380,5407
66000180007,臺中市,大雅區,三和里,臺中市第03選區,楊瓊瓔,中國國民黨,2076,857,1631,recall_disagree_votes,445,2488,5042,5167
65000060015,新北市,新店區,永安里,新北市第11選區,羅明才,中國國民黨,1757,719,1314,recall_disagree_votes,443,2033,4270,4378
66000180008,臺中市,大雅區,西寶里,臺中市第03選區,楊瓊瓔,中國國民黨,1820,772,1378,recall_disagree_votes,442,2150,4587,4638
65000060007,新北市,新店區,寶安里,新北市第11選區,羅明才,中國國民黨,2120,788,1680,recall_disagree_votes,440,2468,4715,4735
66000250015,臺中市,龍井區,新東里,臺中市第02選區,顏寬恒,中國國民黨,1793,832,1355,recall_disagree_votes,438,2187,4661,4658
68000010070,桃園市,桃園區,中聖里,桃園市第04選區,萬美玲,中國國民黨,2369,1093,1932,recall_disagree_votes,437,3025,5265,5298
65000060005,新北市,新店區,江陵里,新北市第11選區,羅明才,中國國民黨,2127,812,1690,recall_disagree_votes,437,2502,4768,4830
66000030022,臺中市,南區,崇倫里,臺中市第06選區,羅廷瑋,中國國民黨,2192,1463,1756,recall_disagree_votes,436,3219,5373,5276
65000170002,新北市,林口區,林口里,新北市第01選區,洪孟楷,中國國民黨,1746,1115,1311,recall_disagree_votes,435,2426,4765,4679
68000010022,桃園市,桃園區,新埔里,桃園市第04選區,萬美玲,中國國民黨,2043,1098,1610,recall_disagree_votes,433,2708,4645,4678
68000010065,桃園市,桃園區,中原里,桃園市第04選區,萬美玲,中國國民黨,1994,971,1561,recall_disagree_votes,433,2532,4359,4379
66000170009,臺中市,潭子區,大豐里,臺中市第03選區,楊瓊瓔,中國國民黨,2331,1131,1899,recall_disagree_votes,432,3030,6166,5923
66000260002,臺中市,霧峰區,吉峰里,臺中市第02選區,顏寬恒,中國國民黨,3186,1597,2754,recall_disagree_votes,432,4351,8853,8850
65000160007,新北市,泰山區,義學里,新北市第01選區,洪孟楷,中國國民黨,1547,1047,1115,recall_disagree_votes,432,2162,4025,3994
65000180006,新北市,深坑區,埔新里,新北市第11選區,羅明才,中國國民黨,2043,1072,1612,recall_disagree_votes,431,2684,5507,5509
65000100032,新北市,淡水區,油車里,新北市第01選區,洪孟楷,中國國民黨,1970,1170,1544,recall_disagree_votes,426,2714,4830,4782
63000040041,臺北市,中山區,金泰里,臺北市第03選區,王鴻薇,中國國民黨,2479,1677,2054,recall_disagree_votes,425,3731,6389,6292
65000010098,新北市,板橋區,崑崙里,新北市第07選區,葉元之,中國國民黨,2651,2166,2226,recall_disagree_votes,425,4392,8109,8166
63000030040,臺北市,大安區,龍淵里,臺北市第06選區,羅智強,中國國民黨,2643,1858,2219,recall_disagree_votes,424,4077,6981,7096
65000060006,新北市,新店區,寶興里,新北市第11選區,羅明才,中國國民黨,2136,885,1714,recall_disagree_votes,422,2599,4941,4849
63000010019,臺北市,松山區,安平里,臺北市第03選區,王鴻薇,中國國民黨,2480,1912,2058,recall_disagree_votes,422,3970,6682,6838
63000010004,臺北市,松山區,三民里,臺北市第03選區,王鴻薇,中國國民黨,2257,1475,1836,recall_disagree_votes,421,3311,5442,5485
66000080017,臺中市,北屯區,仁和里,臺中市第05選區,黃健豪,中國國民黨,3046,2029,2626,recall_disagree_votes,420,4655,9489,9202
68000010024,桃園市,桃園區,慈文里,桃園市第04選區,萬美玲,中國國民黨,2283,1480,1864,recall_disagree_votes,419,3344,6207,6176
68000070031,桃園市,龜山區,文青里,桃園市第01選區,牛煦庭,中國國民黨,3501,2329,3085,recall_disagree_votes,416,5414,9820,8901
66000170016,臺中市,潭子區,家福里,臺中市第03選區,楊瓊瓔,中國國民黨,1883,802,1468,recall_disagree_votes,415,2270,4537,4521
63000040015,臺北市,中山區,成功里,臺北市第03選區,王鴻薇,中國國民黨,1906,1431,1492,recall_disagree_votes,414,2923,5044,5086
66000250007,臺中市,龍井區,龍津里,臺中市第02選區,顏寬恒,中國國民黨,1859,764,1445,recall_disagree_votes,414,2209,4676,4819
68000010069,桃園市,桃園區,北埔里,桃園市第04選區,萬美玲,中國國民黨,1981,1034,1568,recall_disagree_votes,413,2602,4727,4663
65000160006,新北市,泰山區,同榮里,新北市第01選區,洪孟楷,中國國民黨,1517,918,1105,recall_disagree_votes,412,2023,3626,3564
65000060045,新北市,新店區,中華里,新北市第11選區,羅明才,中國國民黨,1777,581,1368,recall_disagree_votes,409,1949,3889,3918
65000110008,新北市,汐止區,復興里,新北市第12選區,廖先翔,中國國民黨,2665,1720,2256,recall_disagree_votes,409,3976,6400,6208
65000060023,新北市,新店區,員潭里,新北市第11選區,羅明才,中國國民黨,1905,714,1496,recall_disagree_votes,409,2210,4597,4605
65000060038,新北市,新店區,新生里,新北市第11選區,羅明才,中國國民黨,2276,845,1868,recall_disagree_votes,408,2713,5061,5053
66000130017,臺中市,沙鹿區,公明里,臺中市第02選區,顏寬恒,中國國民黨,1808,578,1400,recall_disagree_votes,408,1978,4047,4111
10008020010,南投縣,埔里鎮,枇杷里,南投縣第01選區,馬文君,中國國民黨,2613,1003,2206,recall_disagree_votes,407,3209,6677,6744
63000010011,臺北市,松山區,東光里,臺北市第03選區,王鴻薇,中國國民黨,2370,1453,1963,recall_disagree_votes,407,3416,5595,5719
65000060030,新北市,新店區,青潭里,新北市第11選區,羅明才,中國國民黨,1888,824,1484,recall_disagree_votes,404,2308,4838,4774
66000250010,臺中市,龍井區,山腳里,臺中市第02選區,顏寬恒,中國國民黨,2232,947,1829,recall_disagree_votes,403,2776,5650,5616
65000060054,新北市,新店區,中央里,新北市第11選區,羅明才,中國國民黨,2429,913,2027,recall_disagree_votes,402,2940,5282,5211
66000240015,臺中市,大肚區,瑞井里,臺中市第02選區,顏寬恒,中國國民黨,1856,877,1455,recall_disagree_votes,401,2332,4870,4849
63000020028,臺北市,信義區,景新里,臺北市第07選區,徐巧芯,中國國民黨,1758,1031,1359,recall_disagree_votes,399,2390,4024,4137
66000070022,臺中市,南屯區,惠中里,臺中市第04選區,廖偉翔,中國國民黨,2947,2118,2548,recall_disagree_votes,399,4666,8200,7900
66000030009,臺中市,南區,福平里,臺中市第06選區,羅廷瑋,中國國民黨,1979,1418,1582,recall_disagree_votes,397,3000,5215,5118
65000010080,新北市,板橋區,重慶里,新北市第07選區,葉元之,中國國民黨,2468,1832,2071,recall_disagree_votes,397,3903,7146,7268
63000010015,臺北市,松山區,中華里,臺北市第03選區,王鴻薇,中國國民黨,2120,1274,1727,recall_disagree_votes,393,3001,4902,4995
66000130015,臺中市,沙鹿區,南勢里,臺中市第02選區,顏寬恒,中國國民黨,1526,499,1134,recall_disagree_votes,392,1633,3331,3296
63000030010,臺北市,大安區,光武里,臺北市第06選區,羅智強,中國國民黨,2158,1467,1767,recall_disagree_votes,391,3234,5972,6035
63000030021,臺北市,大安區,錦華里,臺北市第06選區,羅智強,中國國民黨,1826,1109,1437,recall_disagree_votes,389,2546,4317,4458
65000100039,新北市,淡水區,民權里,新北市第01選區,洪孟楷,中國國民黨,1807,1226,1418,recall_disagree_votes,389,2644,4423,4282
65000100034,新北市,淡水區,新義里,新北市第01選區,洪孟楷,中國國民黨,1380,865,991,recall_disagree_votes,389,1856,3465,3571
63000030022,臺北市,大安區,龍圖里,臺北市第06選區,羅智強,中國國民黨,2176,1245,1788,recall_disagree_votes,388,3033,5372,5438
66000180006,臺中市,大雅區,橫山里,臺中市第03選區,楊瓊瓔,中國國民黨,1697,708,1309,recall_disagree_votes,388,2017,4045,4160
66000160014,臺中市,神岡區,新庄里,臺中市第03選區,楊瓊瓔,中國國民黨,1528,605,1141,recall_disagree_votes,387,1746,3831,3883
65000100041,新北市,淡水區,學府里,新北市第01選區,洪孟楷,中國國民黨,1631,891,1247,recall_disagree_votes,384,2138,4273,4167
65000060068,新北市,新店區,達觀里,新北市第11選區,羅明才,中國國民黨,1767,484,1384,recall_disagree_votes,383,1868,3737,3574
63000030050,臺北市,大安區,建倫里,臺北市第06選區,羅智強,中國國民黨,1787,1124,1404,recall_disagree_votes,383,2528,4739,4862
68000070002,桃園市,龜山區,龜山里,桃園市第01選區,牛煦庭,中國國民黨,2194,1659,1811,recall_disagree_votes,383,3470,6268,6216
68000010062,桃園市,桃園區,中信里,桃園市第04選區,萬美玲,中國國民黨,2098,1272,1717,recall_disagree_votes,381,2989,5560,5412
65000110026,新北市,汐止區,中興里,新北市第12選區,廖先翔,中國國民黨,2468,1662,2087,recall_disagree_votes,381,3749,6991,6852
66000070025,臺中市,南屯區,三義里,臺中市第04選區,廖偉翔,中國國民黨,2513,1566,2133,recall_disagree_votes,380,3699,6328,6204
68000010066,桃園市,桃園區,中泰里,桃園市第04選區,萬美玲,中國國民黨,1814,927,1434,recall_disagree_votes,380,2361,4006,3997
65000060064,新北市,新店區,安昌里,新北市第11選區,羅明才,中國國民黨,2078,807,1699,recall_disagree_votes,379,2506,4743,4748
63000020030,臺北市,信義區,三張里,臺北市第07選區,徐巧芯,中國國民黨,2863,1776,2485,recall_disagree_votes,378,4261,6926,7084
10009130002,雲林縣,麥寮鄉,麥豐村,雲林縣第01選區,丁學忠,中國國民黨,2604,1163,2226,recall_disagree_votes,378,3389,7514,7470
65000010113,新北市,板橋區,成和里,新北市第07選區,葉元之,中國國民黨,1945,1444,1568,recall_disagree_votes,377,3012,5843,5882
63000010017,臺北市,松山區,民福里,臺北市第03選區,王鴻薇,中國國民黨,2249,1283,1873,recall_disagree_votes,376,3156,5040,5137
66000190007,臺中市,新社區,永源里,臺中市第08選區,江啟臣,中國國民黨,1247,402,872,recall_disagree_votes,375,1274,2786,2824
65000230004,新北市,八里區,埤頭里,新北市第01選區,洪孟楷,中國國民黨,1558,1057,1183,recall_disagree_votes,375,2240,4340,4104
65000100037,新北市,淡水區,正德里,新北市第01選區,洪孟楷,中國國民黨,1731,995,1357,recall_disagree_votes,374,2352,4268,4025
65000160011,新北市,泰山區,同興里,新北市第01選區,洪孟楷,中國國民黨,1235,844,861,recall_disagree_votes,374,1705,3051,3090
66000090028,臺中市,豐原區,中陽里,臺中市第08選區,江啟臣,中國國民黨,2046,1034,1672,recall_disagree_votes,374,2706,5036,5033
65000110012,新北市,汐止區,保長里,新北市第12選區,廖先翔,中國國民黨,1515,1070,1143,recall_disagree_votes,372,2213,4121,4088
65000010057,新北市,板橋區,海山里,新北市第07選區,葉元之,中國國民黨,2178,1786,1806,recall_disagree_votes,372,3592,6105,6238
63000020001,臺北市,信義區,西村里,臺北市第07選區,徐巧芯,中國國民黨,1912,691,1541,recall_disagree_votes,371,2232,3532,3633
65000060051,新北市,新店區,福民里,新北市第11選區,羅明才,中國國民黨,1713,492,1343,recall_disagree_votes,370,1835,3603,3580
66000180011,臺中市,大雅區,四德里,臺中市第03選區,楊瓊瓔,中國國民黨,1809,763,1439,recall_disagree_votes,370,2202,4296,4359
65000100036,新北市,淡水區,新民里,新北市第01選區,洪孟楷,中國國民黨,1712,1008,1343,recall_disagree_votes,369,2351,4288,4164
66000180005,臺中市,大雅區,忠義里,臺中市第03選區,楊瓊瓔,中國國民黨,1737,285,1368,recall_disagree_votes,369,1653,3355,3208
63000030043,臺北市,大安區,大學里,臺北市第06選區,羅智強,中國國民黨,2571,1816,2202,recall_disagree_votes,369,4018,6764,6818
65000110043,新北市,汐止區,湖興里,新北市第12選區,廖先翔,中國國民黨,2478,1333,2110,recall_disagree_votes,368,3443,5997,5866
63000040034,臺北市,中山區,朱馥里,臺北市第03選區,王鴻薇,中國國民黨,1710,1196,1343,recall_disagree_votes,367,2539,4557,4684
66000190001,臺中市,新社區,新社里,臺中市第08選區,江啟臣,中國國民黨,1531,394,1165,recall_disagree_votes,366,1559,3101,3093
68000070008,桃園市,龜山區,精忠里,桃園市第01選區,牛煦庭,中國國民黨,2332,873,1967,recall_disagree_votes,365,2840,4999,4950
66000170011,臺中市,潭子區,嘉仁里,臺中市第03選區,楊瓊瓔,中國國民黨,1547,691,1183,recall_disagree_votes,364,1874,3777,3858
66000040014,臺中市,西區,吉龍里,臺中市第06選區,羅廷瑋,中國國民黨,2253,1651,1890,recall_disagree_votes,363,3541,6169,6235
10008040014,南投縣,竹山鎮,延和里,南投縣第02選區,游顥,中國國民黨,1649,736,1286,recall_disagree_votes,363,2022,4543,4638
66000260008,臺中市,霧峰區,本堂里,臺中市第02選區,顏寬恒,中國國民黨,2257,939,1896,recall_disagree_votes,361,2835,5548,5611
10009030008,雲林縣,虎尾鎮,平和里,雲林縣第01選區,丁學忠,中國國民黨,2053,982,1692,recall_disagree_votes,361,2674,4595,4481
65000170001,新北市,林口區,東林里,新北市第01選區,洪孟楷,中國國民黨,1168,840,807,recall_disagree_votes,361,1647,3182,3235
66000180001,臺中市,大雅區,大雅里,臺中市第03選區,楊瓊瓔,中國國民黨,1816,680,1455,recall_disagree_votes,361,2135,4168,4198
63000100034,臺北市,內湖區,金湖里,臺北市第04選區,李彥秀,中國國民黨,2968,1909,2607,recall_disagree_votes,361,4516,7768,7872
65000040013,新北市,永和區,保安里,新北市第09選區,林德福,中國國民黨,2316,1435,1955,recall_disagree_votes,361,3390,5890,5896
63000020039,臺北市,信義區,黎平里,臺北市第07選區,徐巧芯,中國國民黨,2360,1512,2000,recall_disagree_votes,360,3512,5594,5684
66000020010,臺中市,東區,十甲里,臺中市第06選區,羅廷瑋,中國國民黨,1849,1377,1489,recall_disagree_votes,360,2866,4877,4784
65000110007,新北市,汐止區,新昌里,新北市第12選區,廖先翔,中國國民黨,1799,1185,1440,recall_disagree_votes,359,2625,4707,4682
65000100033,新北市,淡水區,沙崙里,新北市第01選區,洪孟楷,中國國民黨,1875,979,1516,recall_disagree_votes,359,2495,4981,4662
66000090030,臺中市,豐原區,南村里,臺中市第08選區,江啟臣,中國國民黨,1934,1038,1575,recall_disagree_votes,359,2613,5161,5150
63000020036,臺北市,信義區,雙和里,臺北市第07選區,徐巧芯,中國國民黨,2416,1429,2058,recall_disagree_votes,358,3487,5659,5818
65000010095,新北市,板橋區,福安里,新北市第07選區,葉元之,中國國民黨,2462,1561,2107,recall_disagree_votes,355,3668,6543,6317
68000010040,桃園市,桃園區,中興里,桃園市第04選區,萬美玲,中國國民黨,2120,1528,1765,recall_disagree_votes,355,3293,5645,5696
65000160005,新北市,泰山區,楓樹里,新北市第01選區,洪孟楷,中國國民黨,1429,846,1075,recall_disagree_votes,354,1921,3620,3650
66000100008,臺中市,東勢區,泰昌里,臺中市第08選區,江啟臣,中國國民黨,1566,345,1212,recall_disagree_votes,354,1557,3092,3129
65000010087,新北市,板橋區,華東里,新北市第07選區,葉元之,中國國民黨,2740,1824,2387,recall_disagree_votes,353,4211,7074,6919
66000230004,臺中市,烏日區,榮泉里,臺中市第02選區,顏寬恒,中國國民黨,2393,1192,2040,recall_disagree_votes,353,3232,6593,6209
66000250009,臺中市,龍井區,忠和里,臺中市第02選區,顏寬恒,中國國民黨,1782,835,1430,recall_disagree_votes,352,2265,4557,4678
63000030051,臺北市,大安區,敦安里,臺北市第06選區,羅智強,中國國民黨,1725,1224,1373,recall_disagree_votes,352,2597,4797,4892
68000010064,桃園市,桃園區,中平里,桃園市第04選區,萬美玲,中國國民黨,1889,1020,1538,recall_disagree_votes,351,2558,4481,4530
65000100040,新北市,淡水區,幸福里,新北市第01選區,洪孟楷,中國國民黨,1305,817,956,recall_disagree_votes,349,1773,3238,3316
66000090024,臺中市,豐原區,鎌村里,臺中市第08選區,江啟臣,中國國民黨,1810,762,1461,recall_disagree_votes,349,2223,4358,4444
65000010092,新北市,板橋區,中山里,新北市第07選區,葉元之,中國國民黨,2119,1411,1770,recall_disagree_votes,349,3181,6064,5981
66000130011,臺中市,沙鹿區,北勢里,臺中市第02選區,顏寬恒,中國國民黨,1958,861,1609,recall_disagree_votes,349,2470,5166,4951
63000030015,臺北市,大安區,龍安里,臺北市第06選區,羅智強,中國國民黨,1835,1300,1488,recall_disagree_votes,347,2788,6197,6228
66000090015,臺中市,豐原區,東湳里,臺中市第08選區,江啟臣,中國國民黨,1439,774,1093,recall_disagree_votes,346,1867,3782,3866
65000170017,新北市,林口區,麗園里,新北市第01選區,洪孟楷,中國國民黨,1438,882,1093,recall_disagree_votes,345,1975,3396,3387
65000060059,新北市,新店區,小城里,新北市第11選區,羅明才,中國國民黨,1461,501,1116,recall_disagree_votes,345,1617,3180,3191
65000100023,新北市,淡水區,中興里,新北市第01選區,洪孟楷,中國國民黨,1376,830,1033,recall_disagree_votes,343,1863,3567,3534
66000070010,臺中市,南屯區,三厝里,臺中市第04選區,廖偉翔,中國國民黨,2613,1808,2270,recall_disagree_votes,343,4078,7290,7074
65000160008,新北市,泰山區,明志里,新北市第01選區,洪孟楷,中國國民黨,1271,878,929,recall_disagree_votes,342,1807,3157,3222
63000090016,臺北市,南港區,舊莊里,臺北市第04選區,李彥秀,中國國民黨,2524,1674,2182,recall_disagree_votes,342,3856,7212,7285
65000010070,新北市,板橋區,福丘里,新北市第07選區,葉元之,中國國民黨,1640,1055,1299,recall_disagree_votes,341,2354,4127,4098
63000040028,臺北市,中山區,江寧里,臺北市第03選區,王鴻薇,中國國民黨,2074,1634,1734,recall_disagree_votes,340,3368,5553,5605
65000210002,新北市,三芝區,埔頭里,新北市第01選區,洪孟楷,中國國民黨,1822,889,1482,recall_disagree_votes,340,2371,4609,4579
68000010026,桃園市,桃園區,南門里,桃園市第04選區,萬美玲,中國國民黨,2119,1383,1780,recall_disagree_votes,339,3163,5665,5670
66000080037,臺中市,北屯區,松和里,臺中市第05選區,黃健豪,中國國民黨,2372,1423,2033,recall_disagree_votes,339,3456,6433,6414
66000070017,臺中市,南屯區,同心里,臺中市第04選區,廖偉翔,中國國民黨,1936,1286,1597,recall_disagree_votes,339,2883,5226,5147
65000060069,新北市,新店區,華城里,新北市第11選區,羅明才,中國國民黨,1179,460,841,recall_disagree_votes,338,1301,2671,2584
66000170013,臺中市,潭子區,聚興里,臺中市第03選區,楊瓊瓔,中國國民黨,1551,612,1214,recall_disagree_votes,337,1826,4258,4138
65000060055,新北市,新店區,明城里,新北市第11選區,羅明才,中國國民黨,1443,437,1107,recall_disagree_votes,336,1544,3041,3044
66000150014,臺中市,后里區,眉山里,臺中市第03選區,楊瓊瓔,中國國民黨,1409,382,1074,recall_disagree_votes,335,1456,3137,3186
68000010044,桃園市,桃園區,福安里,桃園市第04選區,萬美玲,中國國民黨,1534,990,1199,recall_disagree_votes,335,2189,3927,3931
65000230007,新北市,八里區,訊塘里,新北市第01選區,洪孟楷,中國國民黨,1956,1099,1622,recall_disagree_votes,334,2721,5220,4627
63000030023,臺北市,大安區,新龍里,臺北市第06選區,羅智強,中國國民黨,2496,1037,2162,recall_disagree_votes,334,3199,5220,5386
63000020022,臺北市,信義區,松友里,臺北市第07選區,徐巧芯,中國國民黨,2050,1392,1717,recall_disagree_votes,333,3109,5152,5280
66000080032,臺中市,北屯區,松強里,臺中市第05選區,黃健豪,中國國民黨,2512,1574,2179,recall_disagree_votes,333,3753,6806,6597
66000130012,臺中市,沙鹿區,福興里,臺中市第02選區,顏寬恒,中國國民黨,1644,650,1312,recall_disagree_votes,332,1962,3975,3840
65000060002,新北市,新店區,明德里,新北市第11選區,羅明才,中國國民黨,1472,571,1140,recall_disagree_votes,332,1711,3450,3461
63000030003,臺北市,大安區,和安里,臺北市第06選區,羅智強,中國國民黨,2034,1244,1703,recall_disagree_votes,331,2947,5170,5196
65000110042,新北市,汐止區,崇德里,新北市第12選區,廖先翔,中國國民黨,1681,1032,1352,recall_disagree_votes,329,2384,4329,4277
10008040003,南投縣,竹山鎮,中山里,南投縣第02選區,游顥,中國國民黨,1601,780,1272,recall_disagree_votes,329,2052,4435,4447
66000030010,臺中市,南區,和平里,臺中市第06選區,羅廷瑋,中國國民黨,1694,1058,1365,recall_disagree_votes,329,2423,4490,4139
66000060031,臺中市,西屯區,何成里,臺中市第04選區,廖偉翔,中國國民黨,2526,1795,2199,recall_disagree_votes,327,3994,7011,6901
65000170004,新北市,林口區,菁湖里,新北市第01選區,洪孟楷,中國國民黨,1335,1073,1008,recall_disagree_votes,327,2081,3572,3602
63000030029,臺北市,大安區,住安里,臺北市第06選區,羅智強,中國國民黨,1590,928,1263,recall_disagree_votes,327,2191,3885,4073
63000030053,臺北市,大安區,敦煌里,臺北市第06選區,羅智強,中國國民黨,1714,1200,1387,recall_disagree_votes,327,2587,4666,4800
66000100012,臺中市,東勢區,新盛里,臺中市第08選區,江啟臣,中國國民黨,2138,689,1812,recall_disagree_votes,326,2501,4775,4673
66000130006,臺中市,沙鹿區,斗抵里,臺中市第02選區,顏寬恒,中國國民黨,1764,817,1438,recall_disagree_votes,326,2255,4497,4419
68000010063,桃園市,桃園區,長德里,桃園市第04選區,萬美玲,中國國民黨,1803,1257,1478,recall_disagree_votes,325,2735,4737,4733
66000240016,臺中市,大肚區,蔗廍里,臺中市第02選區,顏寬恒,中國國民黨,1660,899,1335,recall_disagree_votes,325,2234,4842,4739
10008040004,南投縣,竹山鎮,雲林里,南投縣第02選區,游顥,中國國民黨,1331,545,1007,recall_disagree_votes,324,1552,3214,3322
68000010042,桃園市,桃園區,建國里,桃園市第04選區,萬美玲,中國國民黨,1836,1200,1512,recall_disagree_votes,324,2712,4793,4853
65000060062,新北市,新店區,復興里,新北市第11選區,羅明才,中國國民黨,1121,396,798,recall_disagree_votes,323,1194,2626,2828
68000010080,桃園市,桃園區,經國里,桃園市第04選區,萬美玲,中國國民黨,2066,1140,1744,recall_disagree_votes,322,2884,5153,4899
68000010028,桃園市,桃園區,玉山里,桃園市第04選區,萬美玲,中國國民黨,1705,1245,1383,recall_disagree_votes,322,2628,4617,4675
63000030001,臺北市,大安區,德安里,臺北市第06選區,羅智強,中國國民黨,1783,987,1461,recall_disagree_votes,322,2448,4342,4462
63000030055,臺北市,大安區,車層里,臺北市第06選區,羅智強,中國國民黨,1782,1256,1460,recall_disagree_votes,322,2716,4931,4973
66000100010,臺中市,東勢區,福隆里,臺中市第08選區,江啟臣,中國國民黨,1718,430,1397,recall_disagree_votes,321,1827,3578,3564
63000020032,臺北市,信義區,六合里,臺北市第07選區,徐巧芯,中國國民黨,2317,1219,1996,recall_disagree_votes,321,3215,5453,5552
65000160016,新北市,泰山區,福興里,新北市第01選區,洪孟楷,中國國民黨,1249,747,929,recall_disagree_votes,320,1676,3035,3040
66000030007,臺中市,南區,新榮里,臺中市第06選區,羅廷瑋,中國國民黨,1892,1140,1572,recall_disagree_votes,320,2712,4856,4567
63000010030,臺北市,松山區,敦化里,臺北市第07選區,徐巧芯,中國國民黨,2006,1653,1687,recall_disagree_votes,319,3340,5189,5319
63000040035,臺北市,中山區,龍洲里,臺北市第03選區,王鴻薇,中國國民黨,2092,835,1773,recall_disagree_votes,319,2608,4123,4143
63000020006,臺北市,信義區,興雅里,臺北市第07選區,徐巧芯,中國國民黨,1696,1196,1377,recall_disagree_votes,319,2573,4372,4554
66000080028,臺中市,北屯區,平德里,臺中市第05選區,黃健豪,中國國民黨,2167,1444,1849,recall_disagree_votes,318,3293,6088,6005
65000040047,新北市,永和區,秀和里,新北市第09選區,林德福,中國國民黨,1712,926,1394,recall_disagree_votes,318,2320,4095,4105
63000040024,臺北市,中山區,行政里,臺北市第03選區,王鴻薇,中國國民黨,1828,1418,1511,recall_disagree_votes,317,2929,6240,6262
10008040027,南投縣,竹山鎮,延祥里,南投縣第02選區,游顥,中國國民黨,1357,587,1041,recall_disagree_votes,316,1628,3355,3433
66000070021,臺中市,南屯區,大業里,臺中市第04選區,廖偉翔,中國國民黨,2398,1720,2082,recall_disagree_votes,316,3802,6526,6495
68000010054,桃園市,桃園區,中路里,桃園市第04選區,萬美玲,中國國民黨,1561,906,1245,recall_disagree_votes,316,2151,3788,3826
66000030003,臺中市,南區,南門里,臺中市第06選區,羅廷瑋,中國國民黨,1312,967,996,recall_disagree_votes,316,1963,3401,3399
65000110027,新北市,汐止區,湖光里,新北市第12選區,廖先翔,中國國民黨,2299,1403,1984,recall_disagree_votes,315,3387,5780,5591
65000110006,新北市,汐止區,秀峰里,新北市第12選區,廖先翔,中國國民黨,1337,879,1023,recall_disagree_votes,314,1902,4829,4713
63000040010,臺北市,中山區,恆安里,臺北市第03選區,王鴻薇,中國國民黨,1523,1117,1210,recall_disagree_votes,313,2327,4324,4262
65000110031,新北市,汐止區,自強里,新北市第12選區,廖先翔,中國國民黨,1965,1245,1652,recall_disagree_votes,313,2897,5141,5072
63000030056,臺北市,大安區,光信里,臺北市第06選區,羅智強,中國國民黨,2221,1485,1909,recall_disagree_votes,312,3394,5782,5829
68000010073,桃園市,桃園區,明德里,桃園市第04選區,萬美玲,中國國民黨,1351,681,1040,recall_disagree_votes,311,1721,3083,3088
63000010007,臺北市,松山區,新東里,臺北市第03選區,王鴻薇,中國國民黨,1654,1073,1343,recall_disagree_votes,311,2416,3855,3980
65000010078,新北市,板橋區,廣德里,新北市第07選區,葉元之,中國國民黨,1980,1554,1670,recall_disagree_votes,310,3224,5725,5804
66000080039,臺中市,北屯區,平興里,臺中市第05選區,黃健豪,中國國民黨,2492,1514,2183,recall_disagree_votes,309,3697,6745,6505
68000040034,桃園市,楊梅區,瑞坪里,桃園市第02選區,涂權吉,中國國民黨,2517,1100,2208,recall_disagree_votes,309,3308,6198,6015
63000030007,臺北市,大安區,民輝里,臺北市第06選區,羅智強,中國國民黨,1897,1348,1589,recall_disagree_votes,308,2937,5297,5445
63000020026,臺北市,信義區,大道里,臺北市第07選區,徐巧芯,中國國民黨,1825,1485,1517,recall_disagree_votes,308,3002,4896,4943
65000110047,新北市,汐止區,建成里,新北市第12選區,廖先翔,中國國民黨,2010,1064,1702,recall_disagree_votes,308,2766,4585,4559
65000010086,新北市,板橋區,華德里,新北市第07選區,葉元之,中國國民黨,2041,1488,1734,recall_disagree_votes,307,3222,5917,5927
63000010032,臺北市,松山區,復建里,臺北市第07選區,徐巧芯,中國國民黨,1417,993,1111,recall_disagree_votes,306,2104,3530,3562
65000060049,新北市,新店區,福德里,新北市第11選區,羅明才,中國國民黨,1370,495,1065,recall_disagree_votes,305,1560,3277,3304
65000060042,新北市,新店區,新安里,新北市第11選區,羅明才,中國國民黨,1587,589,1282,recall_disagree_votes,305,1871,3634,3506
65000040016,新北市,永和區,民族里,新北市第09選區,林德福,中國國民黨,1659,813,1354,recall_disagree_votes,305,2167,3807,3818
65000040039,新北市,永和區,得和里,新北市第09選區,林德福,中國國民黨,1576,706,1272,recall_disagree_votes,304,1978,3397,3536
68000010081,桃園市,桃園區,檜樂里,桃園市第01選區,牛煦庭,中國國民黨,2257,1282,1954,recall_disagree_votes,303,3236,5889,5895
63000010033,臺北市,松山區,復勢里,臺北市第07選區,徐巧芯,中國國民黨,1815,1512,1512,recall_disagree_votes,303,3024,5030,5052
63000040002,臺北市,中山區,正義里,臺北市第03選區,王鴻薇,中國國民黨,1566,1138,1264,recall_disagree_votes,302,2402,4454,4421
65000040044,新北市,永和區,和平里,新北市第09選區,林德福,中國國民黨,1570,899,1269,recall_disagree_votes,301,2168,3967,4058
66000050023,臺中市,北區,長青里,臺中市第05選區,黃健豪,中國國民黨,2052,1412,1751,recall_disagree_votes,301,3163,5609,5708
63000020033,臺北市,信義區,泰和里,臺北市第07選區,徐巧芯,中國國民黨,2332,1513,2031,recall_disagree_votes,301,3544,6239,6298
63000030028,臺北市,大安區,龍生里,臺北市第06選區,羅智強,中國國民黨,2082,1319,1782,recall_disagree_votes,300,3101,5233,5191
65000040036,新北市,永和區,光復里,新北市第09選區,林德福,中國國民黨,607,504,308,recall_disagree_votes,299,812,1429,1464
66000150004,臺中市,后里區,后里里,臺中市第03選區,楊瓊瓔,中國國民黨,1539,545,1241,recall_disagree_votes,298,1786,3443,3506
66000090014,臺中市,豐原區,北湳里,臺中市第08選區,江啟臣,中國國民黨,1275,528,980,recall_disagree_votes,295,1508,2944,2961
66000080005,臺中市,北屯區,平和里,臺中市第05選區,黃健豪,中國國民黨,1915,1163,1621,recall_disagree_votes,294,2784,5047,4989
68000010012,桃園市,桃園區,東埔里,桃園市第04選區,萬美玲,中國國民黨,1621,1194,1327,recall_disagree_votes,294,2521,4602,4573
65000060050,新北市,新店區,百福里,新北市第11選區,羅明才,中國國民黨,1446,585,1153,recall_disagree_votes,293,1738,3257,3290
65000230002,新北市,八里區,米倉里,新北市第01選區,洪孟楷,中國國民黨,1315,785,1022,recall_disagree_votes,293,1807,3501,3370
63000030017,臺北市,大安區,福住里,臺北市第06選區,羅智強,中國國民黨,1690,1254,1400,recall_disagree_votes,290,2654,4695,4801
66000090036,臺中市,豐原區,朴子里,臺中市第08選區,江啟臣,中國國民黨,1282,579,992,recall_disagree_votes,290,1571,3198,3160
63000030030,臺北市,大安區,義安里,臺北市第06選區,羅智強,中國國民黨,1711,967,1421,recall_disagree_votes,290,2388,4303,4351
63000040040,臺北市,中山區,復華里,臺北市第03選區,王鴻薇,中國國民黨,1549,963,1260,recall_disagree_votes,289,2223,3757,3813
66000030008,臺中市,南區,福興里,臺中市第06選區,羅廷瑋,中國國民黨,1486,1053,1201,recall_disagree_votes,285,2254,3680,3684
68000010043,桃園市,桃園區,大豐里,桃園市第04選區,萬美玲,中國國民黨,1735,1203,1450,recall_disagree_votes,285,2653,4669,4586
63000010008,臺北市,松山區,富泰里,臺北市第03選區,王鴻薇,中國國民黨,1604,884,1319,recall_disagree_votes,285,2203,3693,3700
63000010005,臺北市,松山區,新益里,臺北市第03選區,王鴻薇,中國國民黨,1542,1113,1257,recall_disagree_votes,285,2370,3660,3743
65000040038,新北市,永和區,福和里,新北市第09選區,林德福,中國國民黨,1827,959,1543,recall_disagree_votes,284,2502,4352,4337
66000090021,臺中市,豐原區,中興里,臺中市第08選區,江啟臣,中國國民黨,1253,395,969,recall_disagree_votes,284,1364,2709,2784
66000060023,臺中市,西屯區,何源里,臺中市第04選區,廖偉翔,中國國民黨,2405,1599,2121,recall_disagree_votes,284,3720,6390,6416
65000110036,新北市,汐止區,康福里,新北市第12選區,廖先翔,中國國民黨,1816,1206,1533,recall_disagree_votes,283,2739,4956,4797
63000010002,臺北市,松山區,莊敬里,臺北市第03選區,王鴻薇,中國國民黨,1746,1015,1463,recall_disagree_votes,283,2478,4077,4227
68000040013,桃園市,楊梅區,瑞塘里,桃園市第02選區,涂權吉,中國國民黨,2207,1201,1924,recall_disagree_votes,283,3125,5637,5603
63000010010,臺北市,松山區,精忠里,臺北市第03選區,王鴻薇,中國國民黨,1388,909,1106,recall_disagree_votes,282,2015,3388,3428
66000150003,臺中市,后里區,義里里,臺中市第03選區,楊瓊瓔,中國國民黨,1320,333,1039,recall_disagree_votes,281,1372,2910,2936
63000030014,臺北市,大安區,古莊里,臺北市第06選區,羅智強,中國國民黨,2158,1502,1877,recall_disagree_votes,281,3379,5961,5970
65000060010,新北市,新店區,大鵬里,新北市第11選區,羅明才,中國國民黨,1458,244,1178,recall_disagree_votes,280,1422,2435,2437
65000030030,新北市,中和區,秀景里,新北市第09選區,林德福,中國國民黨,2327,1136,2048,recall_disagree_votes,279,3184,5576,5523
66000050015,臺中市,北區,賴厝里,臺中市第05選區,黃健豪,中國國民黨,1568,859,1289,recall_disagree_votes,279,2148,4959,4873
66000050022,臺中市,北區,明德里,臺中市第05選區,黃健豪,中國國民黨,1848,1313,1569,recall_disagree_votes,279,2882,4970,5028
65000110019,新北市,汐止區,北峰里,新北市第12選區,廖先翔,中國國民黨,1501,1137,1223,recall_disagree_votes,278,2360,4460,4466
66000080041,臺中市,北屯區,三和里,臺中市第05選區,黃健豪,中國國民黨,2161,1276,1883,recall_disagree_votes,278,3159,5484,5462
65000060047,新北市,新店區,百忍里,新北市第11選區,羅明才,中國國民黨,1425,535,1148,recall_disagree_votes,277,1683,3157,3187
65000040023,新北市,永和區,竹林里,新北市第09選區,林德福,中國國民黨,1317,605,1040,recall_disagree_votes,277,1645,3014,3071
66000240001,臺中市,大肚區,王田里,臺中市第02選區,顏寬恒,中國國民黨,1566,765,1289,recall_disagree_votes,277,2054,4148,4189
66000150009,臺中市,后里區,墩北里,臺中市第03選區,楊瓊瓔,中國國民黨,1379,638,1103,recall_disagree_votes,276,1741,3456,3443
66000030002,臺中市,南區,國光里,臺中市第06選區,羅廷瑋,中國國民黨,1321,1054,1045,recall_disagree_votes,276,2099,3601,3632
10009030028,雲林縣,虎尾鎮,立仁里,雲林縣第01選區,丁學忠,中國國民黨,1599,725,1323,recall_disagree_votes,276,2048,3482,3525
68000070015,桃園市,龜山區,新路里,桃園市第01選區,牛煦庭,中國國民黨,1768,1253,1493,recall_disagree_votes,275,2746,4805,4866
63000010020,臺北市,松山區,鵬程里,臺北市第03選區,王鴻薇,中國國民黨,1762,973,1487,recall_disagree_votes,275,2460,3849,3853
63000010027,臺北市,松山區,中崙里,臺北市第07選區,徐巧芯,中國國民黨,1266,898,991,recall_disagree_votes,275,1889,3116,3163
10008020007,南投縣,埔里鎮,清新里,南投縣第01選區,馬文君,中國國民黨,1336,556,1063,recall_disagree_votes,273,1619,3306,3351
65000110046,新北市,汐止區,秀山里,新北市第12選區,廖先翔,中國國民黨,1625,925,1353,recall_disagree_votes,272,2278,4035,4045
65000060004,新北市,新店區,大同里,新北市第11選區,羅明才,中國國民黨,1498,615,1226,recall_disagree_votes,272,1841,3330,3320
66000180015,臺中市,大雅區,雅楓里,臺中市第03選區,楊瓊瓔,中國國民黨,1375,493,1103,recall_disagree_votes,272,1596,3261,3303
63000010006,臺北市,松山區,富錦里,臺北市第03選區,王鴻薇,中國國民黨,1703,1098,1431,recall_disagree_votes,272,2529,4066,4184
68000010011,桃園市,桃園區,永安里,桃園市第04選區,萬美玲,中國國民黨,1503,1249,1232,recall_disagree_votes,271,2481,4306,4400
66000090031,臺中市,豐原區,南田里,臺中市第08選區,江啟臣,中國國民黨,1208,581,938,recall_disagree_votes,270,1519,2981,3065
66000080038,臺中市,北屯區,平陽里,臺中市第05選區,黃健豪,中國國民黨,1742,1088,1472,recall_disagree_votes,270,2560,4613,4657
65000160009,新北市,泰山區,貴子里,新北市第01選區,洪孟楷,中國國民黨,1324,963,1054,recall_disagree_votes,270,2017,3465,3452
63000020018,臺北市,信義區,永春里,臺北市第07選區,徐巧芯,中國國民黨,1458,1160,1189,recall_disagree_votes,269,2349,3938,4034
66000090018,臺中市,豐原區,豐圳里,臺中市第08選區,江啟臣,中國國民黨,1375,561,1107,recall_disagree_votes,268,1668,3083,3170
65000030027,新北市,中和區,秀山里,新北市第09選區,林德福,中國國民黨,1603,778,1335,recall_disagree_votes,268,2113,3814,3897
63000010025,臺北市,松山區,復盛里,臺北市第07選區,徐巧芯,中國國民黨,2020,1322,1753,recall_disagree_votes,267,3075,4883,5038
63000090017,臺北市,南港區,中研里,臺北市第04選區,李彥秀,中國國民黨,2624,1901,2357,recall_disagree_votes,267,4258,7184,7410
63000100026,臺北市,內湖區,週美里,臺北市第04選區,李彥秀,中國國民黨,2607,2011,2340,recall_disagree_votes,267,4351,7446,7468
66000150018,臺中市,后里區,義德里,臺中市第03選區,楊瓊瓔,中國國民黨,1093,302,826,recall_disagree_votes,267,1128,2380,2422
63000030016,臺北市,大安區,錦安里,臺北市第06選區,羅智強,中國國民黨,1717,1225,1451,recall_disagree_votes,266,2676,4564,4649
65000060013,新北市,新店區,下城里,新北市第11選區,羅明才,中國國民黨,1007,531,741,recall_disagree_votes,266,1272,2843,2849
66000180004,臺中市,大雅區,秀山里,臺中市第03選區,楊瓊瓔,中國國民黨,1365,534,1099,recall_disagree_votes,266,1633,3192,3251
63000020002,臺北市,信義區,正和里,臺北市第07選區,徐巧芯,中國國民黨,1556,831,1290,recall_disagree_votes,266,2121,3537,3589
65000160014,新北市,泰山區,新明里,新北市第01選區,洪孟楷,中國國民黨,1055,718,789,recall_disagree_votes,266,1507,2647,2713
63000030036,臺北市,大安區,群賢里,臺北市第06選區,羅智強,中國國民黨,1850,1005,1585,recall_disagree_votes,265,2590,4504,4578
65000060066,新北市,新店區,新和里,新北市第11選區,羅明才,中國國民黨,1528,495,1263,recall_disagree_votes,265,1758,3481,3515
66000020015,臺中市,東區,富仁里,臺中市第06選區,羅廷瑋,中國國民黨,1900,720,1635,recall_disagree_votes,265,2355,4086,3847
63000030037,臺北市,大安區,群英里,臺北市第06選區,羅智強,中國國民黨,2788,982,2524,recall_disagree_votes,264,3506,5620,5733
66000190002,臺中市,新社區,復盛里,臺中市第08選區,江啟臣,中國國民黨,807,175,543,recall_disagree_votes,264,718,1659,1686
65000160002,新北市,泰山區,黎明里,新北市第01選區,洪孟楷,中國國民黨,1142,782,879,recall_disagree_votes,263,1661,2974,2944
65000110048,新北市,汐止區,城中里,新北市第12選區,廖先翔,中國國民黨,1708,980,1445,recall_disagree_votes,263,2425,4081,4016
63000100032,臺北市,內湖區,秀湖里,臺北市第04選區,李彥秀,中國國民黨,2008,1190,1745,recall_disagree_votes,263,2935,5035,5149
63000090004,臺北市,南港區,三重里,臺北市第04選區,李彥秀,中國國民黨,2165,1436,1902,recall_disagree_votes,263,3338,6132,6210
63000030035,臺北市,大安區,全安里,臺北市第06選區,羅智強,中國國民黨,1389,789,1127,recall_disagree_votes,262,1916,3372,3552
65000110037,新北市,汐止區,忠山里,新北市第12選區,廖先翔,中國國民黨,1429,632,1168,recall_disagree_votes,261,1800,3061,3042
68000010034,桃園市,桃園區,光興里,桃園市第04選區,萬美玲,中國國民黨,1511,1228,1250,recall_disagree_votes,261,2478,4269,4320
66000060035,臺中市,西屯區,福恩里,臺中市第04選區,廖偉翔,中國國民黨,1804,1199,1544,recall_disagree_votes,260,2743,4795,4694
65000110020,新北市,汐止區,北山里,新北市第12選區,廖先翔,中國國民黨,1920,1338,1661,recall_disagree_votes,259,2999,5258,5145
65000010082,新北市,板橋區,和平里,新北市第07選區,葉元之,中國國民黨,1355,823,1097,recall_disagree_votes,258,1920,3392,3364
63000020029,臺北市,信義區,惠安里,臺北市第07選區,徐巧芯,中國國民黨,2149,1212,1891,recall_disagree_votes,258,3103,5125,5224
65000060065,新北市,新店區,長春里,新北市第11選區,羅明才,中國國民黨,1053,421,795,recall_disagree_votes,258,1216,2261,2233
66000030018,臺中市,南區,平和里,臺中市第06選區,羅廷瑋,中國國民黨,1265,1020,1008,recall_disagree_votes,257,2028,3361,3345
63000090011,臺北市,南港區,成福里,臺北市第04選區,李彥秀,中國國民黨,2463,1400,2207,recall_disagree_votes,256,3607,5933,6119
65000030022,新北市,中和區,安平里,新北市第09選區,林德福,中國國民黨,2312,1073,2056,recall_disagree_votes,256,3129,5097,5106
65000040030,新北市,永和區,潭墘里,新北市第09選區,林德福,中國國民黨,1687,789,1432,recall_disagree_votes,255,2221,3812,3811
65000230003,新北市,八里區,大崁里,新北市第01選區,洪孟楷,中國國民黨,1198,823,943,recall_disagree_votes,255,1766,3259,3115
63000020007,臺北市,信義區,敦厚里,臺北市第07選區,徐巧芯,中國國民黨,1552,1118,1297,recall_disagree_votes,255,2415,4017,4102
65000040049,新北市,永和區,民生里,新北市第09選區,林德福,中國國民黨,1351,718,1097,recall_disagree_votes,254,1815,3133,3243
66000250004,臺中市,龍井區,田中里,臺中市第02選區,顏寬恒,中國國民黨,1610,625,1356,recall_disagree_votes,254,1981,3929,3724
65000110003,新北市,汐止區,智慧里,新北市第12選區,廖先翔,中國國民黨,1665,975,1412,recall_disagree_votes,253,2387,4181,4128
68000050032,桃園市,蘆竹區,吉祥里,桃園市第01選區,牛煦庭,中國國民黨,1481,920,1228,recall_disagree_votes,253,2148,3756,3703
63000040011,臺北市,中山區,晴光里,臺北市第03選區,王鴻薇,中國國民黨,1637,1245,1384,recall_disagree_votes,253,2629,4878,4633
65000060003,新北市,新店區,大豐里,新北市第11選區,羅明才,中國國民黨,1336,567,1084,recall_disagree_votes,252,1651,3145,3133
68000040004,桃園市,楊梅區,永寧里,桃園市第02選區,涂權吉,中國國民黨,2764,1432,2513,recall_disagree_votes,251,3945,7949,7702
66000160012,臺中市,神岡區,溪洲里,臺中市第03選區,楊瓊瓔,中國國民黨,1089,486,838,recall_disagree_votes,251,1324,2613,2676
63000040013,臺北市,中山區,劍潭里,臺北市第03選區,王鴻薇,中國國民黨,1643,400,1392,recall_disagree_votes,251,1792,2886,2966
66000070018,臺中市,南屯區,向心里,臺中市第04選區,廖偉翔,中國國民黨,1820,1267,1571,recall_disagree_votes,249,2838,5605,5392
10009030024,雲林縣,虎尾鎮,頂溪里,雲林縣第01選區,丁學忠,中國國民黨,1094,513,845,recall_disagree_votes,249,1358,2412,2451
65000110021,新北市,汐止區,白雲里,新北市第12選區,廖先翔,中國國民黨,1559,974,1310,recall_disagree_votes,249,2284,4194,4029
63000030054,臺北市,大安區,華聲里,臺北市第06選區,羅智強,中國國民黨,1241,811,993,recall_disagree_votes,248,1804,3253,3333
63000030011,臺北市,大安區,龍坡里,臺北市第06選區,羅智強,中國國民黨,1666,1227,1418,recall_disagree_votes,248,2645,4455,4485
10008040007,南投縣,竹山鎮,桂林里,南投縣第02選區,游顥,中國國民黨,1219,616,971,recall_disagree_votes,248,1587,3431,3458
66000190009,臺中市,新社區,協成里,臺中市第08選區,江啟臣,中國國民黨,1142,344,894,recall_disagree_votes,248,1238,2797,2760
63000020040,臺北市,信義區,黎忠里,臺北市第07選區,徐巧芯,中國國民黨,1615,930,1367,recall_disagree_votes,248,2297,3800,3948
63000030005,臺北市,大安區,仁愛里,臺北市第06選區,羅智強,中國國民黨,1384,954,1136,recall_disagree_votes,248,2090,3965,4023
66000070013,臺中市,南屯區,黎明里,臺中市第04選區,廖偉翔,中國國民黨,1704,890,1457,recall_disagree_votes,247,2347,3813,3935
10008020026,南投縣,埔里鎮,牛眠里,南投縣第01選區,馬文君,中國國民黨,1075,454,829,recall_disagree_votes,246,1283,2689,2707
66000050018,臺中市,北區,淡溝里,臺中市第05選區,黃健豪,中國國民黨,1739,1411,1493,recall_disagree_votes,246,2904,5023,4886
65000040051,新北市,永和區,上林里,新北市第09選區,林德福,中國國民黨,1332,567,1087,recall_disagree_votes,245,1654,2883,2941
65000040056,新北市,永和區,店街里,新北市第09選區,林德福,中國國民黨,1432,744,1187,recall_disagree_votes,245,1931,3570,3525
66000240003,臺中市,大肚區,福山里,臺中市第02選區,顏寬恒,中國國民黨,1346,602,1102,recall_disagree_votes,244,1704,3299,3327
65000030029,新北市,中和區,秀福里,新北市第09選區,林德福,中國國民黨,1642,991,1398,recall_disagree_votes,244,2389,4213,4207
66000250008,臺中市,龍井區,三德里,臺中市第02選區,顏寬恒,中國國民黨,1096,436,852,recall_disagree_votes,244,1288,2730,2789
66000170010,臺中市,潭子區,栗林里,臺中市第03選區,楊瓊瓔,中國國民黨,1790,939,1546,recall_disagree_votes,244,2485,5001,4746
66000090026,臺中市,豐原區,陽明里,臺中市第08選區,江啟臣,中國國民黨,1057,483,814,recall_disagree_votes,243,1297,2481,2523
65000060001,新北市,新店區,國豐里,新北市第11選區,羅明才,中國國民黨,1197,426,954,recall_disagree_votes,243,1380,2660,2683
66000080004,臺中市,北屯區,平田里,臺中市第05選區,黃健豪,中國國民黨,2023,1291,1780,recall_disagree_votes,243,3071,5577,5477
66000050036,臺中市,北區,賴福里,臺中市第05選區,黃健豪,中國國民黨,1439,1004,1196,recall_disagree_votes,243,2200,3680,3733
65000040035,新北市,永和區,民樂里,新北市第09選區,林德福,中國國民黨,1735,781,1493,recall_disagree_votes,242,2274,3760,3809
10009130001,雲林縣,麥寮鄉,麥津村,雲林縣第01選區,丁學忠,中國國民黨,1501,617,1259,recall_disagree_votes,242,1876,4222,4244
66000160001,臺中市,神岡區,神岡里,臺中市第03選區,楊瓊瓔,中國國民黨,1246,497,1004,recall_disagree_votes,242,1501,3029,3041
65000040011,新北市,永和區,永元里,新北市第09選區,林德福,中國國民黨,1549,928,1308,recall_disagree_votes,241,2236,3821,3891
65000040034,新北市,永和區,民本里,新北市第09選區,林德福,中國國民黨,1283,726,1042,recall_disagree_votes,241,1768,3286,3282
63000010029,臺北市,松山區,吉仁里,臺北市第07選區,徐巧芯,中國國民黨,1126,841,885,recall_disagree_votes,241,1726,3004,3060
66000020013,臺中市,東區,合作里,臺中市第06選區,羅廷瑋,中國國民黨,1750,661,1510,recall_disagree_votes,240,2171,3836,3810
66000100005,臺中市,東勢區,延平里,臺中市第08選區,江啟臣,中國國民黨,934,252,694,recall_disagree_votes,240,946,1929,2018
68000050026,桃園市,蘆竹區,羊稠里,桃園市第01選區,牛煦庭,中國國民黨,1581,1156,1341,recall_disagree_votes,240,2497,4534,4430
63000030006,臺北市,大安區,義村里,臺北市第06選區,羅智強,中國國民黨,2016,919,1776,recall_disagree_votes,240,2695,4453,4517
66000050013,臺中市,北區,建興里,臺中市第05選區,黃健豪,中國國民黨,1801,1358,1561,recall_disagree_votes,240,2919,5105,5191
66000150008,臺中市,后里區,墩南里,臺中市第03選區,楊瓊瓔,中國國民黨,1334,566,1095,recall_disagree_votes,239,1661,3381,3287
65000060048,新北市,新店區,百和里,新北市第11選區,羅明才,中國國民黨,1220,491,981,recall_disagree_votes,239,1472,2760,2784
68000010052,桃園市,桃園區,文中里,桃園市第04選區,萬美玲,中國國民黨,2299,1562,2060,recall_disagree_votes,239,3622,6399,5636
66000050032,臺中市,北區,賴旺里,臺中市第05選區,黃健豪,中國國民黨,1481,892,1244,recall_disagree_votes,237,2136,3999,4038
63000020017,臺北市,信義區,四維里,臺北市第07選區,徐巧芯,中國國民黨,1687,1134,1450,recall_disagree_votes,237,2584,4120,4220
66000080035,臺中市,北屯區,平心里,臺中市第05選區,黃健豪,中國國民黨,1789,1032,1552,recall_disagree_votes,237,2584,4680,4610
66000090032,臺中市,豐原區,南嵩里,臺中市第08選區,江啟臣,中國國民黨,1230,616,994,recall_disagree_votes,236,1610,3223,3223
65000040017,新北市,永和區,民權里,新北市第09選區,林德福,中國國民黨,1555,795,1320,recall_disagree_votes,235,2115,3649,3720
63000020038,臺北市,信義區,黎順里,臺北市第07選區,徐巧芯,中國國民黨,1301,817,1066,recall_disagree_votes,235,1883,3289,3310
66000160009,臺中市,神岡區,大社里,臺中市第03選區,楊瓊瓔,中國國民黨,1578,758,1343,recall_disagree_votes,235,2101,4393,4274
63000030041,臺北市,大安區,龍門里,臺北市第06選區,羅智強,中國國民黨,1221,905,986,recall_disagree_votes,235,1891,3266,3357
10009030010,雲林縣,虎尾鎮,新吉里,雲林縣第01選區,丁學忠,中國國民黨,1532,871,1297,recall_disagree_votes,235,2168,3805,3703
63000040042,臺北市,中山區,北安里,臺北市第03選區,王鴻薇,中國國民黨,897,460,662,recall_disagree_votes,235,1122,1871,2042
65000030033,新北市,中和區,秀仁里,新北市第09選區,林德福,中國國民黨,1130,543,896,recall_disagree_votes,234,1439,2667,2792
66000040022,臺中市,西區,公平里,臺中市第06選區,羅廷瑋,中國國民黨,1772,1244,1539,recall_disagree_votes,233,2783,4987,4873
63000010014,臺北市,松山區,東勢里,臺北市第03選區,王鴻薇,中國國民黨,1288,1043,1055,recall_disagree_votes,233,2098,3341,3389
63000020019,臺北市,信義區,富台里,臺北市第07選區,徐巧芯,中國國民黨,1696,890,1465,recall_disagree_votes,231,2355,3852,3815
68000010077,桃園市,桃園區,大樹里,桃園市第04選區,萬美玲,中國國民黨,1412,847,1181,recall_disagree_votes,231,2028,3724,3719
66000080021,臺中市,北屯區,同榮里,臺中市第05選區,黃健豪,中國國民黨,2022,1248,1791,recall_disagree_votes,231,3039,5168,5198
66000080033,臺中市,北屯區,松勇里,臺中市第05選區,黃健豪,中國國民黨,1924,1196,1693,recall_disagree_votes,231,2889,4785,4889
65000060026,新北市,新店區,屈尺里,新北市第11選區,羅明才,中國國民黨,782,416,552,recall_disagree_votes,230,968,2231,2258
65000100038,新北市,淡水區,北新里,新北市第01選區,洪孟楷,中國國民黨,1043,603,814,recall_disagree_votes,229,1417,2793,2606
65000160015,新北市,泰山區,貴賢里,新北市第01選區,洪孟楷,中國國民黨,1302,862,1074,recall_disagree_votes,228,1936,3204,3190
63000040007,臺北市,中山區,聚盛里,臺北市第03選區,王鴻薇,中國國民黨,1244,811,1016,recall_disagree_votes,228,1827,3551,3473
65000040028,新北市,永和區,河堤里,新北市第09選區,林德福,中國國民黨,1228,590,1000,recall_disagree_votes,228,1590,2903,2906
66000050021,臺中市,北區,健行里,臺中市第05選區,黃健豪,中國國民黨,2150,1746,1923,recall_disagree_votes,227,3669,6288,6314
63000010009,臺北市,松山區,介壽里,臺北市第03選區,王鴻薇,中國國民黨,1290,957,1064,recall_disagree_votes,226,2021,3368,3431
65000160004,新北市,泰山區,福泰里,新北市第01選區,洪孟楷,中國國民黨,890,554,665,recall_disagree_votes,225,1219,2245,2339
65000110032,新北市,汐止區,文化里,新北市第12選區,廖先翔,中國國民黨,1615,944,1390,recall_disagree_votes,225,2334,4095,4022
66000030001,臺中市,南區,城隍里,臺中市第06選區,羅廷瑋,中國國民黨,1294,958,1069,recall_disagree_votes,225,2027,3372,3409
63000030049,臺北市,大安區,建安里,臺北市第06選區,羅智強,中國國民黨,1421,900,1197,recall_disagree_votes,224,2097,3756,3842
65000110015,新北市,汐止區,拱北里,新北市第12選區,廖先翔,中國國民黨,1505,943,1282,recall_disagree_votes,223,2225,4562,4482
66000260003,臺中市,霧峰區,甲寅里,臺中市第02選區,顏寬恒,中國國民黨,1719,799,1498,recall_disagree_votes,221,2297,4639,4571
66000090033,臺中市,豐原區,翁明里,臺中市第08選區,江啟臣,中國國民黨,954,371,733,recall_disagree_votes,221,1104,2141,2175
65000230008,新北市,八里區,荖阡里,新北市第01選區,洪孟楷,中國國民黨,641,346,420,recall_disagree_votes,221,766,1520,1566
68000010017,桃園市,桃園區,中埔里,桃園市第04選區,萬美玲,中國國民黨,1181,845,960,recall_disagree_votes,221,1805,3392,3275
63000030032,臺北市,大安區,通安里,臺北市第06選區,羅智強,中國國民黨,1675,1147,1455,recall_disagree_votes,220,2602,4338,4398
68000040027,桃園市,楊梅區,楊明里,桃園市第02選區,涂權吉,中國國民黨,3236,1535,3016,recall_disagree_votes,220,4551,8301,7786
66000170003,臺中市,潭子區,潭北里,臺中市第03選區,楊瓊瓔,中國國民黨,1055,389,836,recall_disagree_votes,219,1225,2399,2371
66000030005,臺中市,南區,積善里,臺中市第06選區,羅廷瑋,中國國民黨,945,726,726,recall_disagree_votes,219,1452,2410,2440
66000250006,臺中市,龍井區,麗水里,臺中市第02選區,顏寬恒,中國國民黨,1081,250,862,recall_disagree_votes,219,1112,2114,2133
66000100018,臺中市,東勢區,東新里,臺中市第08選區,江啟臣,中國國民黨,963,251,745,recall_disagree_votes,218,996,1871,1902
65000230005,新北市,八里區,頂罟里,新北市第01選區,洪孟楷,中國國民黨,805,476,587,recall_disagree_votes,218,1063,2195,2123
65000060043,新北市,新店區,忠誠里,新北市第11選區,羅明才,中國國民黨,953,383,735,recall_disagree_votes,218,1118,1997,2115
66000060039,臺中市,西屯區,福雅里,臺中市第04選區,廖偉翔,中國國民黨,2167,1384,1949,recall_disagree_votes,218,3333,5952,5661
65000220003,新北市,石門區,老梅里,新北市第01選區,洪孟楷,中國國民黨,719,354,501,recall_disagree_votes,218,855,1816,1944
65000110034,新北市,汐止區,福德里,新北市第12選區,廖先翔,中國國民黨,1111,756,893,recall_disagree_votes,218,1649,3159,3081
10009030018,雲林縣,虎尾鎮,埒內里,雲林縣第01選區,丁學忠,中國國民黨,989,624,772,recall_disagree_votes,217,1396,2488,2494
65000040046,新北市,永和區,下溪里,新北市第09選區,林德福,中國國民黨,1611,906,1394,recall_disagree_votes,217,2300,3952,3918
63000090018,臺北市,南港區,九如里,臺北市第04選區,李彥秀,中國國民黨,2072,1079,1855,recall_disagree_votes,217,2934,4989,5140
63000020011,臺北市,信義區,雅祥里,臺北市第07選區,徐巧芯,中國國民黨,1481,1208,1264,recall_disagree_votes,217,2472,4108,4123
68000070027,桃園市,龜山區,大湖里,桃園市第01選區,牛煦庭,中國國民黨,1903,1369,1686,recall_disagree_votes,217,3055,5929,5521
66000150011,臺中市,后里區,舊社里,臺中市第03選區,楊瓊瓔,中國國民黨,903,303,687,recall_disagree_votes,216,990,2193,2186
65000040055,新北市,永和區,桂林里,新北市第09選區,林德福,中國國民黨,1341,569,1125,recall_disagree_votes,216,1694,3118,3134
65000180007,新北市,深坑區,萬福里,新北市第11選區,羅明才,中國國民黨,842,473,626,recall_disagree_votes,216,1099,2435,2407
68000010078,桃園市,桃園區,大業里,桃園市第01選區,牛煦庭,中國國民黨,1767,1158,1551,recall_disagree_votes,216,2709,4941,4902
63000030052,臺北市,大安區,正聲里,臺北市第06選區,羅智強,中國國民黨,1396,802,1181,recall_disagree_votes,215,1983,3561,3640
65000100006,新北市,淡水區,義山里,新北市第01選區,洪孟楷,中國國民黨,875,446,660,recall_disagree_votes,215,1106,2063,2156
65000030023,新北市,中和區,中安里,新北市第09選區,林德福,中國國民黨,1816,783,1602,recall_disagree_votes,214,2385,3846,3884
66000160011,臺中市,神岡區,神洲里,臺中市第03選區,楊瓊瓔,中國國民黨,912,495,698,recall_disagree_votes,214,1193,2397,2423
65000180004,新北市,深坑區,昇高里,新北市第11選區,羅明才,中國國民黨,833,307,619,recall_disagree_votes,214,926,1845,1856
63000020031,臺北市,信義區,三犁里,臺北市第07選區,徐巧芯,中國國民黨,1640,1066,1426,recall_disagree_votes,214,2492,4241,4334
10017060013,基隆市,安樂區,內寮里,基隆市第01選區,林沛祥,中國國民黨,1794,1077,1580,recall_disagree_votes,214,2657,5277,5233
66000070011,臺中市,南屯區,溝墘里,臺中市第04選區,廖偉翔,中國國民黨,1983,1453,1770,recall_disagree_votes,213,3223,5245,5248
66000230012,臺中市,烏日區,溪埧里,臺中市第02選區,顏寬恒,中國國民黨,1635,816,1422,recall_disagree_votes,213,2238,4366,4292
66000080030,臺中市,北屯區,松茂里,臺中市第05選區,黃健豪,中國國民黨,1988,1142,1775,recall_disagree_votes,213,2917,5020,5029
68000010067,桃園市,桃園區,南埔里,桃園市第04選區,萬美玲,中國國民黨,1982,1457,1769,recall_disagree_votes,213,3226,5892,5104
63000020023,臺北市,信義區,松光里,臺北市第07選區,徐巧芯,中國國民黨,1429,1139,1216,recall_disagree_votes,213,2355,3922,4025
63000020004,臺北市,信義區,中興里,臺北市第07選區,徐巧芯,中國國民黨,1075,684,863,recall_disagree_votes,212,1547,2805,2790
65000060061,新北市,新店區,建國里,新北市第11選區,羅明才,中國國民黨,1218,408,1006,recall_disagree_votes,212,1414,2600,2691
68000070006,桃園市,龜山區,山頂里,桃園市第01選區,牛煦庭,中國國民黨,1719,1114,1507,recall_disagree_votes,212,2621,5033,5063
63000090005,臺北市,南港區,東新里,臺北市第04選區,李彥秀,中國國民黨,1971,1370,1759,recall_disagree_votes,212,3129,5533,5547
66000090034,臺中市,豐原區,翁子里,臺中市第08選區,江啟臣,中國國民黨,1347,524,1136,recall_disagree_votes,211,1660,3306,3171
66000160007,臺中市,神岡區,三角里,臺中市第03選區,楊瓊瓔,中國國民黨,1000,498,789,recall_disagree_votes,211,1287,2593,2507
65000180002,新北市,深坑區,萬順里,新北市第11選區,羅明才,中國國民黨,780,424,570,recall_disagree_votes,210,994,2301,2272
68000040001,桃園市,楊梅區,楊梅里,桃園市第02選區,涂權吉,中國國民黨,1684,777,1475,recall_disagree_votes,209,2252,3804,3758
10009030006,雲林縣,虎尾鎮,西安里,雲林縣第01選區,丁學忠,中國國民黨,1236,603,1027,recall_disagree_votes,209,1630,2980,3003
63000030044,臺北市,大安區,芳和里,臺北市第06選區,羅智強,中國國民黨,1787,1150,1580,recall_disagree_votes,207,2730,4559,4655
65000010084,新北市,板橋區,華興里,新北市第07選區,葉元之,中國國民黨,1283,969,1076,recall_disagree_votes,207,2045,3529,3576
65000060039,新北市,新店區,新德里,新北市第11選區,羅明才,中國國民黨,908,430,701,recall_disagree_votes,207,1131,2279,2302
66000150016,臺中市,后里區,公館里,臺中市第03選區,楊瓊瓔,中國國民黨,872,274,665,recall_disagree_votes,207,939,2040,2086
66000030014,臺中市,南區,西川里,臺中市第06選區,羅廷瑋,中國國民黨,1612,1075,1406,recall_disagree_votes,206,2481,4091,4092
66000100004,臺中市,東勢區,南平里,臺中市第08選區,江啟臣,中國國民黨,908,175,702,recall_disagree_votes,206,877,1605,1664
65000060011,新北市,新店區,太平里,新北市第11選區,羅明才,中國國民黨,1153,445,947,recall_disagree_votes,206,1392,2688,2686
65000010072,新北市,板橋區,民族里,新北市第07選區,葉元之,中國國民黨,1312,1056,1107,recall_disagree_votes,205,2163,3661,3741
66000020004,臺中市,東區,東興里,臺中市第06選區,羅廷瑋,中國國民黨,996,804,791,recall_disagree_votes,205,1595,2713,2717
66000160003,臺中市,神岡區,北庄里,臺中市第03選區,楊瓊瓔,中國國民黨,1013,507,808,recall_disagree_votes,205,1315,2449,2501
65000040003,新北市,永和區,豫溪里,新北市第09選區,林德福,中國國民黨,1303,676,1098,recall_disagree_votes,205,1774,4601,4413
65000060009,新北市,新店區,忠孝里,新北市第11選區,羅明才,中國國民黨,1110,369,906,recall_disagree_votes,204,1275,2478,2458
66000080026,臺中市,北屯區,平安里,臺中市第05選區,黃健豪,中國國民黨,1839,1283,1635,recall_disagree_votes,204,2918,5129,5085
68000070029,桃園市,龜山區,長庚里,桃園市第01選區,牛煦庭,中國國民黨,1746,1373,1543,recall_disagree_votes,203,2916,5519,4944
65000060033,新北市,新店區,國校里,新北市第11選區,羅明才,中國國民黨,877,411,675,recall_disagree_votes,202,1086,2258,2263
65000290001,新北市,烏來區,烏來里,新北市第11選區,羅明才,中國國民黨,482,208,281,recall_disagree_votes,201,489,1315,1367
65000030075,新北市,中和區,安順里,新北市第09選區,林德福,中國國民黨,1666,846,1465,recall_disagree_votes,201,2311,3836,3834
65000060063,新北市,新店區,美城里,新北市第11選區,羅明才,中國國民黨,1015,389,814,recall_disagree_votes,201,1203,2323,2386
63000020035,臺北市,信義區,景勤里,臺北市第07選區,徐巧芯,中國國民黨,1241,793,1040,recall_disagree_votes,201,1833,3061,3186
66000080036,臺中市,北屯區,平福里,臺中市第05選區,黃健豪,中國國民黨,1436,812,1235,recall_disagree_votes,201,2047,3373,3395
68000010046,桃園市,桃園區,大興里,桃園市第01選區,牛煦庭,中國國民黨,1639,1337,1438,recall_disagree_votes,201,2775,5233,5179
66000100019,臺中市,東勢區,粵寧里,臺中市第08選區,江啟臣,中國國民黨,861,274,661,recall_disagree_votes,200,935,1871,1908
66000250001,臺中市,龍井區,竹坑里,臺中市第02選區,顏寬恒,中國國民黨,1329,464,1129,recall_disagree_votes,200,1593,3104,3032
68000040014,桃園市,楊梅區,四維里,桃園市第02選區,涂權吉,中國國民黨,2006,876,1806,recall_disagree_votes,200,2682,4706,4613
68000010045,桃園市,桃園區,三民里,桃園市第01選區,牛煦庭,中國國民黨,1669,857,1469,recall_disagree_votes,200,2326,3922,4030
66000080031,臺中市,北屯區,大德里,臺中市第05選區,黃健豪,中國國民黨,1834,987,1635,recall_disagree_votes,199,2622,4419,4493
66000150013,臺中市,后里區,太平里,臺中市第03選區,楊瓊瓔,中國國民黨,890,219,691,recall_disagree_votes,199,910,1969,2033
65000040008,新北市,永和區,民治里,新北市第09選區,林德福,中國國民黨,1023,437,824,recall_disagree_votes,199,1261,2370,2394
68000070019,桃園市,龜山區,大崗里,桃園市第01選區,牛煦庭,中國國民黨,1328,960,1129,recall_disagree_votes,199,2089,3967,4002
66000240007,臺中市,大肚區,大東里,臺中市第02選區,顏寬恒,中國國民黨,1150,499,951,recall_disagree_votes,199,1450,2802,2858
10008020011,南投縣,埔里鎮,水頭里,南投縣第01選區,馬文君,中國國民黨,1331,544,1132,recall_disagree_votes,199,1676,3569,3545
66000030004,臺中市,南區,德義里,臺中市第06選區,羅廷瑋,中國國民黨,1124,750,925,recall_disagree_votes,199,1675,2806,2773
66000080023,臺中市,北屯區,水湳里,臺中市第05選區,黃健豪,中國國民黨,2434,1692,2236,recall_disagree_votes,198,3928,6835,6501
65000040014,新北市,永和區,中溪里,新北市第09選區,林德福,中國國民黨,1623,1026,1425,recall_disagree_votes,198,2451,4253,4268
66000190006,臺中市,新社區,大南里,臺中市第08選區,江啟臣,中國國民黨,814,226,617,recall_disagree_votes,197,843,1742,1776
65000040001,新北市,永和區,福林里,新北市第09選區,林德福,中國國民黨,1130,658,933,recall_disagree_votes,197,1591,2779,2758
65000040015,新北市,永和區,永安里,新北市第09選區,林德福,中國國民黨,1520,800,1323,recall_disagree_votes,197,2123,3539,3545
66000160013,臺中市,神岡區,圳前里,臺中市第03選區,楊瓊瓔,中國國民黨,895,347,699,recall_disagree_votes,196,1046,2059,2120
68000010053,桃園市,桃園區,泰山里,桃園市第04選區,萬美玲,中國國民黨,1330,890,1134,recall_disagree_votes,196,2024,3506,3505
66000240006,臺中市,大肚區,新興里,臺中市第02選區,顏寬恒,中國國民黨,994,395,800,recall_disagree_votes,194,1195,2386,2432
68000070025,桃園市,龜山區,迴龍里,桃園市第01選區,牛煦庭,中國國民黨,1849,1324,1655,recall_disagree_votes,194,2979,5833,5787
63000040009,臺北市,中山區,聚葉里,臺北市第03選區,王鴻薇,中國國民黨,1116,892,922,recall_disagree_votes,194,1814,3275,3310
66000060003,臺中市,西屯區,潮洋里,臺中市第04選區,廖偉翔,中國國民黨,2029,1501,1835,recall_disagree_votes,194,3336,7344,6685
10008040028,南投縣,竹山鎮,竹圍里,南投縣第02選區,游顥,中國國民黨,799,327,605,recall_disagree_votes,194,932,2105,2141
63000030034,臺北市,大安區,法治里,臺北市第06選區,羅智強,中國國民黨,1557,809,1364,recall_disagree_votes,193,2173,3564,3679
66000040025,臺中市,西區,大忠里,臺中市第06選區,羅廷瑋,中國國民黨,1582,1189,1389,recall_disagree_votes,193,2578,4195,4201
68000070007,桃園市,龜山區,陸光里,桃園市第01選區,牛煦庭,中國國民黨,2090,282,1898,recall_disagree_votes,192,2180,3382,3366
63000020024,臺北市,信義區,中坡里,臺北市第07選區,徐巧芯,中國國民黨,1371,1021,1179,recall_disagree_votes,192,2200,3486,3558
68000050025,桃園市,蘆竹區,營盤里,桃園市第01選區,牛煦庭,中國國民黨,1740,1125,1548,recall_disagree_votes,192,2673,4781,4691
66000150001,臺中市,后里區,廣福里,臺中市第03選區,楊瓊瓔,中國國民黨,910,197,719,recall_disagree_votes,191,916,1856,1881
63000010035,臺北市,松山區,松基里,臺北市第03選區,王鴻薇,中國國民黨,1045,901,854,recall_disagree_votes,191,1755,2920,2937
68000010016,桃園市,桃園區,長安里,桃園市第04選區,萬美玲,中國國民黨,1210,862,1019,recall_disagree_votes,191,1881,3292,3353
68000010035,桃園市,桃園區,龍山里,桃園市第04選區,萬美玲,中國國民黨,1211,647,1021,recall_disagree_votes,190,1668,3243,3285
66000290001,臺中市,和平區,南勢里,臺中市第08選區,江啟臣,中國國民黨,640,138,450,recall_disagree_votes,190,588,1423,1447
63000100029,臺北市,內湖區,湖興里,臺北市第04選區,李彥秀,中國國民黨,2085,1527,1895,recall_disagree_votes,190,3422,7078,7231
10008020032,南投縣,埔里鎮,北梅里,南投縣第01選區,馬文君,中國國民黨,1182,451,992,recall_disagree_votes,190,1443,2928,2919
63000020034,臺北市,信義區,景聯里,臺北市第07選區,徐巧芯,中國國民黨,1480,994,1290,recall_disagree_votes,190,2284,3676,3712
65000110041,新北市,汐止區,大同里,新北市第12選區,廖先翔,中國國民黨,971,597,782,recall_disagree_votes,189,1379,2529,2490
10017060021,基隆市,安樂區,武崙里,基隆市第01選區,林沛祥,中國國民黨,1903,1062,1714,recall_disagree_votes,189,2776,4944,4768
63000030019,臺北市,大安區,光明里,臺北市第06選區,羅智強,中國國民黨,1072,737,883,recall_disagree_votes,189,1620,2803,2886
66000080040,臺中市,北屯區,平昌里,臺中市第05選區,黃健豪,中國國民黨,1566,1016,1377,recall_disagree_votes,189,2393,4299,4259
63000090003,臺北市,南港區,新富里,臺北市第04選區,李彥秀,中國國民黨,1062,804,873,recall_disagree_votes,189,1677,3029,3124
65000040004,新北市,永和區,光明里,新北市第09選區,林德福,中國國民黨,1125,530,937,recall_disagree_votes,188,1467,2486,2510
65000040025,新北市,永和區,安和里,新北市第09選區,林德福,中國國民黨,1393,736,1205,recall_disagree_votes,188,1941,3266,3277
66000200007,臺中市,石岡區,梅子里,臺中市第08選區,江啟臣,中國國民黨,795,234,607,recall_disagree_votes,188,841,1688,1741
63000090001,臺北市,南港區,南港里,臺北市第04選區,李彥秀,中國國民黨,1659,1141,1471,recall_disagree_votes,188,2612,5111,5285
66000060027,臺中市,西屯區,上安里,臺中市第04選區,廖偉翔,中國國民黨,1856,1261,1669,recall_disagree_votes,187,2930,5249,5153
63000100039,臺北市,內湖區,寶湖里,臺北市第04選區,李彥秀,中國國民黨,2995,1859,2808,recall_disagree_votes,187,4667,7997,7906
68000010037,桃園市,桃園區,成功里,桃園市第04選區,萬美玲,中國國民黨,1400,940,1213,recall_disagree_votes,187,2153,3677,3786
65000040060,新北市,永和區,秀元里,新北市第09選區,林德福,中國國民黨,1024,590,837,recall_disagree_votes,187,1427,2505,2560
10008020003,南投縣,埔里鎮,西門里,南投縣第01選區,馬文君,中國國民黨,1059,461,872,recall_disagree_votes,187,1333,2649,2713
65000010071,新北市,板橋區,福祿里,新北市第07選區,葉元之,中國國民黨,1254,798,1067,recall_disagree_votes,187,1865,3362,3429
68000070013,桃園市,龜山區,中興里,桃園市第01選區,牛煦庭,中國國民黨,1489,1137,1303,recall_disagree_votes,186,2440,4396,4433
65000040033,新北市,永和區,保平里,新北市第09選區,林德福,中國國民黨,1477,1063,1291,recall_disagree_votes,186,2354,4094,3998
63000010034,臺北市,松山區,福成里,臺北市第07選區,徐巧芯,中國國民黨,764,583,579,recall_disagree_votes,185,1162,2010,2061
66000240017,臺中市,大肚區,自強里,臺中市第02選區,顏寬恒,中國國民黨,1310,531,1125,recall_disagree_votes,185,1656,3299,3244
65000180008,新北市,深坑區,賴仲里,新北市第11選區,羅明才,中國國民黨,840,366,655,recall_disagree_votes,185,1021,2193,2115
63000040003,臺北市,中山區,正得里,臺北市第03選區,王鴻薇,中國國民黨,1132,883,947,recall_disagree_votes,185,1830,3232,3148
66000200006,臺中市,石岡區,萬興里,臺中市第08選區,江啟臣,中國國民黨,674,202,490,recall_disagree_votes,184,692,1344,1377
66000160015,臺中市,神岡區,圳堵里,臺中市第03選區,楊瓊瓔,中國國民黨,868,348,684,recall_disagree_votes,184,1032,2009,1978
63000030020,臺北市,大安區,錦泰里,臺北市第06選區,羅智強,中國國民黨,1137,727,953,recall_disagree_votes,184,1680,2888,2899
65000010088,新北市,板橋區,信義里,新北市第07選區,葉元之,中國國民黨,1188,942,1005,recall_disagree_votes,183,1947,3616,3702
66000050014,臺中市,北區,頂厝里,臺中市第05選區,黃健豪,中國國民黨,1464,1004,1281,recall_disagree_votes,183,2285,3981,3972
65000040029,新北市,永和區,頂溪里,新北市第09選區,林德福,中國國民黨,920,482,737,recall_disagree_votes,183,1219,2042,2135
66000050025,臺中市,北區,賴興里,臺中市第05選區,黃健豪,中國國民黨,1449,850,1266,recall_disagree_votes,183,2116,3676,3640
65000160013,新北市,泰山區,泰友里,新北市第01選區,洪孟楷,中國國民黨,724,465,541,recall_disagree_votes,183,1006,1692,1746
66000150017,臺中市,后里區,月眉里,臺中市第03選區,楊瓊瓔,中國國民黨,753,322,570,recall_disagree_votes,183,892,1892,1912
66000050017,臺中市,北區,育德里,臺中市第05選區,黃健豪,中國國民黨,1260,864,1078,recall_disagree_votes,182,1942,3454,3466
65000010077,新北市,板橋區,鄉雲里,新北市第07選區,葉元之,中國國民黨,1170,826,988,recall_disagree_votes,182,1814,3185,3227
66000050035,臺中市,北區,梅川里,臺中市第05選區,黃健豪,中國國民黨,1150,757,969,recall_disagree_votes,181,1726,3118,3115
66000090013,臺中市,豐原區,大湳里,臺中市第08選區,江啟臣,中國國民黨,950,434,769,recall_disagree_votes,181,1203,2396,2397
66000080003,臺中市,北屯區,三光里,臺中市第05選區,黃健豪,中國國民黨,2521,1677,2340,recall_disagree_votes,181,4017,6885,6702
68000070020,桃園市,龜山區,文化里,桃園市第01選區,牛煦庭,中國國民黨,2621,2010,2441,recall_disagree_votes,180,4451,8357,7514
66000080006,臺中市,北屯區,東光里,臺中市第05選區,黃健豪,中國國民黨,1539,1132,1359,recall_disagree_votes,180,2491,4406,4434
65000110039,新北市,汐止區,東勢里,新北市第12選區,廖先翔,中國國民黨,1785,1035,1605,recall_disagree_votes,180,2640,4651,4422
66000020011,臺中市,東區,東南里,臺中市第06選區,羅廷瑋,中國國民黨,1456,944,1276,recall_disagree_votes,180,2220,3960,3614
10008090002,南投縣,魚池鄉,魚池村,南投縣第01選區,馬文君,中國國民黨,676,280,497,recall_disagree_votes,179,777,1760,1813
65000010079,新北市,板橋區,大豐里,新北市第07選區,葉元之,中國國民黨,1356,1041,1177,recall_disagree_votes,179,2218,3781,3867
10008020030,南投縣,埔里鎮,北安里,南投縣第01選區,馬文君,中國國民黨,1200,516,1021,recall_disagree_votes,179,1537,2795,2867
63000080040,臺北市,文山區,政大里,臺北市第08選區,賴士葆,中國國民黨,2146,1473,1968,recall_disagree_votes,178,3441,5997,6129
63000030018,臺北市,大安區,永康里,臺北市第06選區,羅智強,中國國民黨,1132,676,954,recall_disagree_votes,178,1630,2815,2866
66000130005,臺中市,沙鹿區,興仁里,臺中市第02選區,顏寬恒,中國國民黨,904,421,726,recall_disagree_votes,178,1147,2272,2339
66000200002,臺中市,石岡區,萬安里,臺中市第08選區,江啟臣,中國國民黨,689,212,511,recall_disagree_votes,178,723,1445,1477
65000040018,新北市,永和區,中興里,新北市第09選區,林德福,中國國民黨,1121,578,943,recall_disagree_votes,178,1521,2760,2774
65000030020,新北市,中和區,安樂里,新北市第09選區,林德福,中國國民黨,1389,687,1212,recall_disagree_votes,177,1899,3200,3163
68000050007,桃園市,蘆竹區,南崁里,桃園市第01選區,牛煦庭,中國國民黨,1244,988,1067,recall_disagree_votes,177,2055,3667,3591
65000040048,新北市,永和區,河濱里,新北市第09選區,林德福,中國國民黨,1142,562,966,recall_disagree_votes,176,1528,2680,2710
66000090010,臺中市,豐原區,西勢里,臺中市第08選區,江啟臣,中國國民黨,834,390,658,recall_disagree_votes,176,1048,2001,2079
63000040001,臺北市,中山區,正守里,臺北市第03選區,王鴻薇,中國國民黨,966,785,790,recall_disagree_votes,176,1575,2694,2753
68000050018,桃園市,蘆竹區,南興里,桃園市第01選區,牛煦庭,中國國民黨,1837,1247,1662,recall_disagree_votes,175,2909,5241,5121
63000100018,臺北市,內湖區,葫洲里,臺北市第04選區,李彥秀,中國國民黨,2142,1259,1967,recall_disagree_votes,175,3226,5558,5756
65000110035,新北市,汐止區,興福里,新北市第12選區,廖先翔,中國國民黨,1171,709,996,recall_disagree_votes,175,1705,3034,2939
66000060036,臺中市,西屯區,福聯里,臺中市第04選區,廖偉翔,中國國民黨,1076,677,901,recall_disagree_votes,175,1578,3301,3216
63000020005,臺北市,信義區,新仁里,臺北市第07選區,徐巧芯,中國國民黨,1119,626,945,recall_disagree_votes,174,1571,2575,2609
65000110049,新北市,汐止區,湖蓮里,新北市第12選區,廖先翔,中國國民黨,1209,622,1035,recall_disagree_votes,174,1657,2748,2577
65000060036,新北市,新店區,文明里,新北市第11選區,羅明才,中國國民黨,852,467,678,recall_disagree_votes,174,1145,2185,2199
10008040015,南投縣,竹山鎮,山崇里,南投縣第02選區,游顥,中國國民黨,651,256,477,recall_disagree_votes,174,733,1685,1731
63000030027,臺北市,大安區,龍雲里,臺北市第06選區,羅智強,中國國民黨,1395,956,1221,recall_disagree_votes,174,2177,3732,3762
66000050034,臺中市,北區,立人里,臺中市第05選區,黃健豪,中國國民黨,1373,804,1199,recall_disagree_votes,174,2003,3633,3612
10008040011,南投縣,竹山鎮,延平里,南投縣第02選區,游顥,中國國民黨,888,423,714,recall_disagree_votes,174,1137,2596,2666
65000010074,新北市,板橋區,福德里,新北市第07選區,葉元之,中國國民黨,1446,1234,1272,recall_disagree_votes,174,2506,4205,4197
63000040038,臺北市,中山區,朱崙里,臺北市第03選區,王鴻薇,中國國民黨,935,722,761,recall_disagree_votes,174,1483,2459,2493
68000040036,桃園市,楊梅區,瑞溪里,桃園市第02選區,涂權吉,中國國民黨,1378,674,1204,recall_disagree_votes,174,1878,3558,3487
65000040027,新北市,永和區,協和里,新北市第09選區,林德福,中國國民黨,981,568,808,recall_disagree_votes,173,1376,2434,2495
10017060024,基隆市,安樂區,鶯安里,基隆市第01選區,林沛祥,中國國民黨,2218,1084,2045,recall_disagree_votes,173,3129,5330,5028
68000040015,桃園市,楊梅區,梅溪里,桃園市第02選區,涂權吉,中國國民黨,1592,738,1419,recall_disagree_votes,173,2157,4046,3991
66000150005,臺中市,后里區,厚里里,臺中市第03選區,楊瓊瓔,中國國民黨,937,345,764,recall_disagree_votes,173,1109,2076,2081
65000040031,新北市,永和區,潭安里,新北市第09選區,林德福,中國國民黨,1722,744,1550,recall_disagree_votes,172,2294,4008,3993
68000010005,桃園市,桃園區,忠義里,桃園市第01選區,牛煦庭,中國國民黨,1275,714,1104,recall_disagree_votes,171,1818,3411,3429
63000040033,臺北市,中山區,中央里,臺北市第03選區,王鴻薇,中國國民黨,1069,932,899,recall_disagree_votes,170,1831,3016,2983
10009130009,雲林縣,麥寮鄉,橋頭村,雲林縣第01選區,丁學忠,中國國民黨,1275,634,1106,recall_disagree_votes,169,1740,4005,4004
63000010013,臺北市,松山區,東昌里,臺北市第03選區,王鴻薇,中國國民黨,737,631,568,recall_disagree_votes,169,1199,1962,1995
66000050009,臺中市,北區,錦洲里,臺中市第05選區,黃健豪,中國國民黨,1207,677,1038,recall_disagree_votes,169,1715,3039,3127
65000040054,新北市,永和區,永興里,新北市第09選區,林德福,中國國民黨,1064,490,895,recall_disagree_votes,169,1385,2585,2654
68000050031,桃園市,蘆竹區,長壽里,桃園市第01選區,牛煦庭,中國國民黨,1967,1233,1798,recall_disagree_votes,169,3031,5340,5280
65000060046,新北市,新店區,仁愛里,新北市第11選區,羅明才,中國國民黨,810,309,642,recall_disagree_votes,168,951,1741,1778
65000040061,新北市,永和區,永樂里,新北市第09選區,林德福,中國國民黨,749,470,581,recall_disagree_votes,168,1051,1912,1983
10009030003,雲林縣,虎尾鎮,東仁里,雲林縣第01選區,丁學忠,中國國民黨,1050,538,882,recall_disagree_votes,168,1420,2380,2407
66000040023,臺中市,西區,公德里,臺中市第06選區,羅廷瑋,中國國民黨,1499,1190,1331,recall_disagree_votes,168,2521,4217,4128
63000100017,臺北市,內湖區,清白里,臺北市第04選區,李彥秀,中國國民黨,2631,1742,2463,recall_disagree_votes,168,4205,7080,7085
68000040028,桃園市,楊梅區,金溪里,桃園市第02選區,涂權吉,中國國民黨,1686,830,1519,recall_disagree_votes,167,2349,4209,3922
66000160002,臺中市,神岡區,庄前里,臺中市第03選區,楊瓊瓔,中國國民黨,987,400,820,recall_disagree_votes,167,1220,2207,2201
63000100003,臺北市,內湖區,西安里,臺北市第04選區,李彥秀,中國國民黨,2031,1401,1864,recall_disagree_votes,167,3265,5333,5398
10008020004,南投縣,埔里鎮,北門里,南投縣第01選區,馬文君,中國國民黨,856,334,689,recall_disagree_votes,167,1023,2246,2297
68000010082,桃園市,桃園區,寶民里,桃園市第01選區,牛煦庭,中國國民黨,1419,844,1252,recall_disagree_votes,167,2096,4104,4059
66000020001,臺中市,東區,新庄里,臺中市第06選區,羅廷瑋,中國國民黨,881,619,715,recall_disagree_votes,166,1334,2813,2857
65000040040,新北市,永和區,智光里,新北市第09選區,林德福,中國國民黨,1063,523,897,recall_disagree_votes,166,1420,2656,2685
66000190005,臺中市,新社區,崑山里,臺中市第08選區,江啟臣,中國國民黨,442,142,277,recall_disagree_votes,165,419,1059,1091
10008030005,南投縣,草屯鎮,山腳里,南投縣第01選區,馬文君,中國國民黨,2939,1316,2774,recall_disagree_votes,165,4090,7585,7521
66000060029,臺中市,西屯區,逢福里,臺中市第04選區,廖偉翔,中國國民黨,1937,1257,1772,recall_disagree_votes,165,3029,5165,5165
63000100019,臺北市,內湖區,紫陽里,臺北市第04選區,李彥秀,中國國民黨,2469,1820,2304,recall_disagree_votes,165,4124,6767,6960
66000260014,臺中市,霧峰區,萬豐里,臺中市第02選區,顏寬恒,中國國民黨,857,476,692,recall_disagree_votes,165,1168,2481,2465
63000090014,臺北市,南港區,百福里,臺北市第04選區,李彥秀,中國國民黨,1491,1077,1327,recall_disagree_votes,164,2404,4270,4332
65000040026,新北市,永和區,水源里,新北市第09選區,林德福,中國國民黨,1360,728,1196,recall_disagree_votes,164,1924,3253,3291
10008020033,南投縣,埔里鎮,泰安里,南投縣第01選區,馬文君,中國國民黨,814,312,650,recall_disagree_votes,164,962,1837,1880
68000040038,桃園市,楊梅區,富豐里,桃園市第02選區,涂權吉,中國國民黨,1215,579,1051,recall_disagree_votes,164,1630,3054,3030
66000060024,臺中市,西屯區,西平里,臺中市第04選區,廖偉翔,中國國民黨,1777,1019,1613,recall_disagree_votes,164,2632,4948,4757
65000180003,新北市,深坑區,土庫里,新北市第11選區,羅明才,中國國民黨,932,448,769,recall_disagree_votes,163,1217,2671,2645
68000040005,桃園市,楊梅區,大平里,桃園市第02選區,涂權吉,中國國民黨,1285,542,1122,recall_disagree_votes,163,1664,2857,2981
65000010073,新北市,板橋區,國泰里,新北市第07選區,葉元之,中國國民黨,1083,767,920,recall_disagree_votes,163,1687,2929,2979
66000060034,臺中市,西屯區,福中里,臺中市第04選區,廖偉翔,中國國民黨,1123,744,960,recall_disagree_votes,163,1704,3061,3127
65000040059,新北市,永和區,民富里,新北市第09選區,林德福,中國國民黨,952,514,789,recall_disagree_votes,163,1303,2354,2398
65000040021,新北市,永和區,秀成里,新北市第09選區,林德福,中國國民黨,945,509,782,recall_disagree_votes,163,1291,2331,2408
68000040023,桃園市,楊梅區,瑞原里,桃園市第02選區,涂權吉,中國國民黨,1446,634,1283,recall_disagree_votes,163,1917,3508,3533
66000100013,臺中市,東勢區,詒福里,臺中市第08選區,江啟臣,中國國民黨,673,218,510,recall_disagree_votes,163,728,1521,1527
66000130002,臺中市,沙鹿區,洛泉里,臺中市第02選區,顏寬恒,中國國民黨,739,396,577,recall_disagree_votes,162,973,1759,1847
63000040037,臺北市,中山區,埤頭里,臺北市第03選區,王鴻薇,中國國民黨,1007,744,845,recall_disagree_votes,162,1589,2764,2757
66000250002,臺中市,龍井區,龍東里,臺中市第02選區,顏寬恒,中國國民黨,1200,403,1038,recall_disagree_votes,162,1441,2966,2823
66000250012,臺中市,龍井區,龍崗里,臺中市第02選區,顏寬恒,中國國民黨,1139,429,977,recall_disagree_votes,162,1406,2634,2648
66000040004,臺中市,西區,東昇里,臺中市第06選區,羅廷瑋,中國國民黨,795,611,633,recall_disagree_votes,162,1244,2074,2109
65000100004,新北市,淡水區,興仁里,新北市第01選區,洪孟楷,中國國民黨,504,336,342,recall_disagree_votes,162,678,1347,1402
68000070032,桃園市,龜山區,楓福里,桃園市第01選區,牛煦庭,中國國民黨,1321,833,1160,recall_disagree_votes,161,1993,3251,3244
66000080029,臺中市,北屯區,松安里,臺中市第05選區,黃健豪,中國國民黨,1731,1114,1570,recall_disagree_votes,161,2684,4737,4672
66000260015,臺中市,霧峰區,舊正里,臺中市第02選區,顏寬恒,中國國民黨,774,318,613,recall_disagree_votes,161,931,1968,1984
66000240008,臺中市,大肚區,大肚里,臺中市第02選區,顏寬恒,中國國民黨,895,402,735,recall_disagree_votes,160,1137,2042,2083
10008040001,南投縣,竹山鎮,竹山里,南投縣第02選區,游顥,中國國民黨,722,327,562,recall_disagree_votes,160,889,1791,1868
65000040006,新北市,永和區,永貞里,新北市第09選區,林德福,中國國民黨,1163,613,1003,recall_disagree_votes,160,1616,2786,2789
68000040007,桃園市,楊梅區,水美里,桃園市第02選區,涂權吉,中國國民黨,1673,808,1513,recall_disagree_votes,160,2321,3977,4005
65000010110,新北市,板橋區,後埔里,新北市第07選區,葉元之,中國國民黨,1231,940,1071,recall_disagree_votes,160,2011,3407,3210
66000080042,臺中市,北屯區,忠平里,臺中市第05選區,黃健豪,中國國民黨,1601,767,1442,recall_disagree_votes,159,2209,3660,3684
66000020006,臺中市,東區,泉源里,臺中市第06選區,羅廷瑋,中國國民黨,757,604,599,recall_disagree_votes,158,1203,2066,2027
68000040040,桃園市,楊梅區,三民里,桃園市第02選區,涂權吉,中國國民黨,1377,601,1219,recall_disagree_votes,158,1820,3330,3255
66000170012,臺中市,潭子區,新田里,臺中市第03選區,楊瓊瓔,中國國民黨,536,270,378,recall_disagree_votes,158,648,1395,1451
65000110033,新北市,汐止區,金龍里,新北市第12選區,廖先翔,中國國民黨,1756,1168,1598,recall_disagree_votes,158,2766,4955,4866
66000150010,臺中市,后里區,中和里,臺中市第03選區,楊瓊瓔,中國國民黨,911,386,753,recall_disagree_votes,158,1139,2391,2321
63000020012,臺北市,信義區,五常里,臺北市第07選區,徐巧芯,中國國民黨,1134,870,976,recall_disagree_votes,158,1846,3005,3018
65000230009,新北市,八里區,長坑里,新北市第01選區,洪孟楷,中國國民黨,604,283,446,recall_disagree_votes,158,729,1388,1445
10009130006,雲林縣,麥寮鄉,後安村,雲林縣第01選區,丁學忠,中國國民黨,958,323,801,recall_disagree_votes,157,1124,2931,3015
66000240005,臺中市,大肚區,社腳里,臺中市第02選區,顏寬恒,中國國民黨,1032,354,876,recall_disagree_votes,156,1230,2218,2274
65000060032,新北市,新店區,張南里,新北市第11選區,羅明才,中國國民黨,959,378,803,recall_disagree_votes,156,1181,2339,2247
66000030006,臺中市,南區,江川里,臺中市第06選區,羅廷瑋,中國國民黨,1028,761,872,recall_disagree_votes,156,1633,2665,2640
65000030031,新北市,中和區,秀明里,新北市第09選區,林德福,中國國民黨,1889,889,1733,recall_disagree_votes,156,2622,4549,4350
10017060023,基隆市,安樂區,興寮里,基隆市第01選區,林沛祥,中國國民黨,1598,931,1442,recall_disagree_votes,156,2373,4594,4492
66000260017,臺中市,霧峰區,六股里,臺中市第02選區,顏寬恒,中國國民黨,872,467,716,recall_disagree_votes,156,1183,2203,2270
66000060006,臺中市,西屯區,上石里,臺中市第04選區,廖偉翔,中國國民黨,1750,1199,1594,recall_disagree_votes,156,2793,5118,4956
68000010057,桃園市,桃園區,大有里,桃園市第01選區,牛煦庭,中國國民黨,2417,1395,2261,recall_disagree_votes,156,3656,6613,6332
63000020003,臺北市,信義區,興隆里,臺北市第07選區,徐巧芯,中國國民黨,846,417,691,recall_disagree_votes,155,1108,2110,2100
10008020019,南投縣,埔里鎮,鐵山里,南投縣第01選區,馬文君,中國國民黨,618,249,463,recall_disagree_votes,155,712,1460,1486
66000130020,臺中市,沙鹿區,興安里,臺中市第02選區,顏寬恒,中國國民黨,1235,682,1080,recall_disagree_votes,155,1762,3782,3319
65000040012,新北市,永和區,秀林里,新北市第09選區,林德福,中國國民黨,1297,854,1142,recall_disagree_votes,155,1996,3348,3294
66000170008,臺中市,潭子區,大富里,臺中市第03選區,楊瓊瓔,中國國民黨,1104,566,950,recall_disagree_votes,154,1516,2908,2853
66000060008,臺中市,西屯區,鵬程里,臺中市第04選區,廖偉翔,中國國民黨,1435,240,1282,recall_disagree_votes,153,1522,2672,2442
65000220006,新北市,石門區,尖鹿里,新北市第01選區,洪孟楷,中國國民黨,549,231,396,recall_disagree_votes,153,627,1313,1362
66000050030,臺中市,北區,建德里,臺中市第05選區,黃健豪,中國國民黨,1186,762,1034,recall_disagree_votes,152,1796,3002,3067
65000110022,新北市,汐止區,橫科里,新北市第12選區,廖先翔,中國國民黨,1450,973,1298,recall_disagree_votes,152,2271,4040,4102
65000230010,新北市,八里區,下罟里,新北市第01選區,洪孟楷,中國國民黨,694,246,542,recall_disagree_votes,152,788,1393,1410
66000260012,臺中市,霧峰區,四德里,臺中市第02選區,顏寬恒,中國國民黨,881,459,729,recall_disagree_votes,152,1188,2381,2409
66000060028,臺中市,西屯區,上德里,臺中市第04選區,廖偉翔,中國國民黨,1479,967,1328,recall_disagree_votes,151,2295,4106,4023
10008040012,南投縣,竹山鎮,延正里,南投縣第02選區,游顥,中國國民黨,572,233,421,recall_disagree_votes,151,654,1591,1621
66000090029,臺中市,豐原區,東陽里,臺中市第08選區,江啟臣,中國國民黨,585,306,434,recall_disagree_votes,151,740,1469,1496
65000100003,新北市,淡水區,賢孝里,新北市第01選區,洪孟楷,中國國民黨,581,278,430,recall_disagree_votes,151,708,1379,1395
63000030013,臺北市,大安區,古風里,臺北市第06選區,羅智強,中國國民黨,1204,860,1054,recall_disagree_votes,150,1914,3241,3331
66000230003,臺中市,烏日區,三和里,臺中市第02選區,顏寬恒,中國國民黨,2660,1532,2510,recall_disagree_votes,150,4042,9142,7452
66000230011,臺中市,烏日區,東園里,臺中市第02選區,顏寬恒,中國國民黨,899,398,749,recall_disagree_votes,150,1147,2208,2201
66000060025,臺中市,西屯區,何南里,臺中市第04選區,廖偉翔,中國國民黨,1483,1035,1333,recall_disagree_votes,150,2368,3943,3989
63000030057,臺北市,大安區,學府里,臺北市第06選區,羅智強,中國國民黨,742,369,592,recall_disagree_votes,150,961,1761,1890
66000150007,臺中市,后里區,墩西里,臺中市第03選區,楊瓊瓔,中國國民黨,707,318,557,recall_disagree_votes,150,875,1854,1860
63000030047,臺北市,大安區,黎孝里,臺北市第06選區,羅智強,中國國民黨,2380,1594,2230,recall_disagree_votes,150,3824,6132,6286
66000100022,臺中市,東勢區,茂興里,臺中市第08選區,江啟臣,中國國民黨,789,212,640,recall_disagree_votes,149,852,1750,1755
10008020001,南投縣,埔里鎮,東門里,南投縣第01選區,馬文君,中國國民黨,952,448,803,recall_disagree_votes,149,1251,2387,2421
63000100002,臺北市,內湖區,西康里,臺北市第04選區,李彥秀,中國國民黨,2904,1894,2755,recall_disagree_votes,149,4649,7890,7963
66000060037,臺中市,西屯區,福瑞里,臺中市第04選區,廖偉翔,中國國民黨,1134,620,986,recall_disagree_votes,148,1606,2964,2882
66000190003,臺中市,新社區,中正里,臺中市第08選區,江啟臣,中國國民黨,630,163,482,recall_disagree_votes,148,645,1332,1323
66000070016,臺中市,南屯區,文心里,臺中市第04選區,廖偉翔,中國國民黨,1397,1012,1249,recall_disagree_votes,148,2261,3828,3747
66000070019,臺中市,南屯區,大誠里,臺中市第04選區,廖偉翔,中國國民黨,1329,975,1182,recall_disagree_votes,147,2157,3694,3596
65000040050,新北市,永和區,秀得里,新北市第09選區,林德福,中國國民黨,948,450,801,recall_disagree_votes,147,1251,2194,2214
66000260009,臺中市,霧峰區,坑口里,臺中市第02選區,顏寬恒,中國國民黨,1082,476,935,recall_disagree_votes,147,1411,2844,2823
66000240011,臺中市,大肚區,永順里,臺中市第02選區,顏寬恒,中國國民黨,687,298,540,recall_disagree_votes,147,838,1601,1635
66000130018,臺中市,沙鹿區,清泉里,臺中市第02選區,顏寬恒,中國國民黨,982,369,835,recall_disagree_votes,147,1204,2253,2237
68000040016,桃園市,楊梅區,高山里,桃園市第02選區,涂權吉,中國國民黨,1476,617,1330,recall_disagree_votes,146,1947,3684,3596
66000040001,臺中市,西區,民生里,臺中市第06選區,羅廷瑋,中國國民黨,630,422,484,recall_disagree_votes,146,906,1651,1653
66000090008,臺中市,豐原區,豐西里,臺中市第08選區,江啟臣,中國國民黨,646,312,500,recall_disagree_votes,146,812,1565,1555
66000260013,臺中市,霧峰區,五福里,臺中市第02選區,顏寬恒,中國國民黨,965,410,819,recall_disagree_votes,146,1229,2512,2545
66000100016,臺中市,東勢區,慶東里,臺中市第08選區,江啟臣,中國國民黨,753,218,608,recall_disagree_votes,145,826,1733,1754
68000050028,桃園市,蘆竹區,福昌里,桃園市第01選區,牛煦庭,中國國民黨,1757,1157,1612,recall_disagree_votes,145,2769,5017,4933
68000070001,桃園市,龜山區,楓樹里,桃園市第01選區,牛煦庭,中國國民黨,1308,1057,1163,recall_disagree_votes,145,2220,3718,3760
66000050008,臺中市,北區,建成里,臺中市第05選區,黃健豪,中國國民黨,1815,1298,1671,recall_disagree_votes,144,2969,5433,5393
10008020028,南投縣,埔里鎮,蜈蚣里,南投縣第01選區,馬文君,中國國民黨,833,339,689,recall_disagree_votes,144,1028,2190,2244
63000010031,臺北市,松山區,復源里,臺北市第07選區,徐巧芯,中國國民黨,1037,736,893,recall_disagree_votes,144,1629,2685,2652
10008040016,南投縣,竹山鎮,社寮里,南投縣第02選區,游顥,中國國民黨,533,204,390,recall_disagree_votes,143,594,1264,1255
63000090006,臺北市,南港區,新光里,臺北市第04選區,李彥秀,中國國民黨,1165,706,1022,recall_disagree_votes,143,1728,2989,3074
66000060014,臺中市,西屯區,大鵬里,臺中市第04選區,廖偉翔,中國國民黨,1736,1035,1593,recall_disagree_votes,143,2628,4579,4508
63000020037,臺北市,信義區,嘉興里,臺北市第07選區,徐巧芯,中國國民黨,969,722,826,recall_disagree_votes,143,1548,2512,2594
66000130019,臺中市,沙鹿區,西勢里,臺中市第02選區,顏寬恒,中國國民黨,844,261,701,recall_disagree_votes,143,962,1929,1985
63000100010,臺北市,內湖區,湖濱里,臺北市第04選區,李彥秀,中國國民黨,2695,1635,2552,recall_disagree_votes,143,4187,6800,6886
66000200010,臺中市,石岡區,和盛里,臺中市第08選區,江啟臣,中國國民黨,584,128,442,recall_disagree_votes,142,570,1128,1162
66000100011,臺中市,東勢區,隆興里,臺中市第08選區,江啟臣,中國國民黨,593,164,452,recall_disagree_votes,141,616,1378,1352
66000240010,臺中市,大肚區,磺溪里,臺中市第02選區,顏寬恒,中國國民黨,742,251,601,recall_disagree_votes,141,852,1603,1623
66000050001,臺中市,北區,光大里,臺中市第05選區,黃健豪,中國國民黨,658,456,518,recall_disagree_votes,140,974,1867,1967
68000040026,桃園市,楊梅區,中山里,桃園市第02選區,涂權吉,中國國民黨,1316,643,1176,recall_disagree_votes,140,1819,3098,2950
66000090001,臺中市,豐原區,豐原里,臺中市第08選區,江啟臣,中國國民黨,908,343,768,recall_disagree_votes,140,1111,2128,2144
10008030027,南投縣,草屯鎮,新厝里,南投縣第01選區,馬文君,中國國民黨,1230,553,1091,recall_disagree_votes,139,1644,3069,3137
10009030005,雲林縣,虎尾鎮,德興里,雲林縣第01選區,丁學忠,中國國民黨,1046,464,907,recall_disagree_votes,139,1371,2429,2377
65000040007,新北市,永和區,永福里,新北市第09選區,林德福,中國國民黨,974,537,835,recall_disagree_votes,139,1372,2297,2296
66000100007,臺中市,東勢區,廣興里,臺中市第08選區,江啟臣,中國國民黨,649,158,510,recall_disagree_votes,139,668,1274,1313
65000220005,新北市,石門區,石門里,新北市第01選區,洪孟楷,中國國民黨,593,246,454,recall_disagree_votes,139,700,1362,1436
10009030004,雲林縣,虎尾鎮,公安里,雲林縣第01選區,丁學忠,中國國民黨,1129,608,991,recall_disagree_votes,138,1599,2651,2675
10017060011,基隆市,安樂區,外寮里,基隆市第01選區,林沛祥,中國國民黨,1298,719,1160,recall_disagree_votes,138,1879,3687,3664
65000060012,新北市,新店區,頂城里,新北市第11選區,羅明才,中國國民黨,485,164,347,recall_disagree_votes,138,511,1256,1283
68000010076,桃園市,桃園區,三元里,桃園市第01選區,牛煦庭,中國國民黨,1403,938,1265,recall_disagree_votes,138,2203,3921,3783
66000260019,臺中市,霧峰區,北勢里,臺中市第02選區,顏寬恒,中國國民黨,977,261,840,recall_disagree_votes,137,1101,1977,1975
65000100009,新北市,淡水區,埤島里,新北市第01選區,洪孟楷,中國國民黨,695,444,558,recall_disagree_votes,137,1002,1858,1752
68000010013,桃園市,桃園區,東門里,桃園市第04選區,萬美玲,中國國民黨,1062,724,925,recall_disagree_votes,137,1649,2931,2934
66000150012,臺中市,后里區,聯合里,臺中市第03選區,楊瓊瓔,中國國民黨,630,199,494,recall_disagree_votes,136,693,1513,1530
10008100002,南投縣,國姓鄉,石門村,南投縣第01選區,馬文君,中國國民黨,647,171,512,recall_disagree_votes,135,683,1574,1617
63000090012,臺北市,南港區,萬福里,臺北市第04選區,李彥秀,中國國民黨,1462,876,1327,recall_disagree_votes,135,2203,3442,3530
65000210009,新北市,三芝區,後厝里,新北市第01選區,洪孟楷,中國國民黨,813,411,679,recall_disagree_votes,134,1090,2132,1981
10008020005,南投縣,埔里鎮,同聲里,南投縣第01選區,馬文君,中國國民黨,843,322,709,recall_disagree_votes,134,1031,2052,2065
66000080024,臺中市,北屯區,陳平里,臺中市第05選區,黃健豪,中國國民黨,1745,982,1611,recall_disagree_votes,134,2593,4500,4501
68000070014,桃園市,龜山區,山德里,桃園市第01選區,牛煦庭,中國國民黨,1518,1175,1384,recall_disagree_votes,134,2559,4487,4497
65000220002,新北市,石門區,富基里,新北市第01選區,洪孟楷,中國國民黨,482,251,349,recall_disagree_votes,133,600,1181,1255
68000050035,桃園市,蘆竹區,興榮里,桃園市第01選區,牛煦庭,中國國民黨,1023,700,890,recall_disagree_votes,133,1590,2719,2704
68000040031,桃園市,楊梅區,青山里,桃園市第02選區,涂權吉,中國國民黨,1534,794,1401,recall_disagree_votes,133,2195,4725,4393
66000060013,臺中市,西屯區,大福里,臺中市第04選區,廖偉翔,中國國民黨,1161,663,1028,recall_disagree_votes,133,1691,3121,3156
10009030020,雲林縣,虎尾鎮,安溪里,雲林縣第01選區,丁學忠,中國國民黨,649,358,516,recall_disagree_votes,133,874,1651,1676
66000250003,臺中市,龍井區,龍西里,臺中市第02選區,顏寬恒,中國國民黨,763,295,630,recall_disagree_votes,133,925,1740,1703
10015050006,花蓮縣,吉安鄉,吉安村,花蓮縣第01選區,傅崐萁,中國國民黨,1663,1241,1530,recall_disagree_votes,133,2771,4684,4655
65000040002,新北市,永和區,文化里,新北市第09選區,林德福,中國國民黨,977,464,844,recall_disagree_votes,133,1308,2317,2365
66000050002,臺中市,北區,文莊里,臺中市第05選區,黃健豪,中國國民黨,1342,635,1210,recall_disagree_votes,132,1845,3076,3109
66000170002,臺中市,潭子區,潭秀里,臺中市第03選區,楊瓊瓔,中國國民黨,463,261,331,recall_disagree_votes,132,592,1148,1203
63000100012,臺北市,內湖區,大湖里,臺北市第04選區,李彥秀,中國國民黨,1631,1077,1499,recall_disagree_votes,132,2576,4284,4419
10008070004,南投縣,鹿谷鄉,廣興村,南投縣第02選區,游顥,中國國民黨,760,254,628,recall_disagree_votes,132,882,1775,1824
65000110024,新北市,汐止區,福山里,新北市第12選區,廖先翔,中國國民黨,1242,818,1110,recall_disagree_votes,132,1928,3399,3342
10008100011,南投縣,國姓鄉,南港村,南投縣第01選區,馬文君,中國國民黨,615,146,483,recall_disagree_votes,132,629,1400,1455
65000040020,新北市,永和區,秀朗里,新北市第09選區,林德福,中國國民黨,1244,761,1112,recall_disagree_votes,132,1873,3241,3225
63000100031,臺北市,內湖區,安湖里,臺北市第04選區,李彥秀,中國國民黨,1989,1425,1857,recall_disagree_votes,132,3282,5608,6055
65000010056,新北市,板橋區,福壽里,新北市第07選區,葉元之,中國國民黨,1034,729,902,recall_disagree_votes,132,1631,2758,2813
10008020017,南投縣,埔里鎮,南村里,南投縣第01選區,馬文君,中國國民黨,519,167,387,recall_disagree_votes,132,554,1214,1271
63000020041,臺北市,信義區,黎安里,臺北市第07選區,徐巧芯,中國國民黨,667,301,536,recall_disagree_votes,131,837,1507,1558
65000030072,新北市,中和區,秀水里,新北市第09選區,林德福,中國國民黨,1379,583,1248,recall_disagree_votes,131,1831,3220,3228
10008020029,南投縣,埔里鎮,合成里,南投縣第01選區,馬文君,中國國民黨,580,216,449,recall_disagree_votes,131,665,1470,1532
66000290007,臺中市,和平區,梨山里,臺中市第08選區,江啟臣,中國國民黨,361,56,230,recall_disagree_votes,131,286,1142,1186
66000100020,臺中市,東勢區,下新里,臺中市第08選區,江啟臣,中國國民黨,672,211,542,recall_disagree_votes,130,753,1533,1563
66000200003,臺中市,石岡區,九房里,臺中市第08選區,江啟臣,中國國民黨,527,176,397,recall_disagree_votes,130,573,1163,1167
66000260018,臺中市,霧峰區,丁台里,臺中市第02選區,顏寬恒,中國國民黨,809,413,679,recall_disagree_votes,130,1092,2188,2227
65000030024,新北市,中和區,泰安里,新北市第09選區,林德福,中國國民黨,1102,722,972,recall_disagree_votes,130,1694,2950,2992
10008080006,南投縣,中寮鄉,永平村,南投縣第01選區,馬文君,中國國民黨,675,218,545,recall_disagree_votes,130,763,1529,1604
63000090007,臺北市,南港區,東明里,臺北市第04選區,李彥秀,中國國民黨,1684,1093,1555,recall_disagree_votes,129,2648,4502,4553
63000100014,臺北市,內湖區,金瑞里,臺北市第04選區,李彥秀,中國國民黨,1913,1468,1784,recall_disagree_votes,129,3252,5331,5519
66000050031,臺中市,北區,崇德里,臺中市第05選區,黃健豪,中國國民黨,1157,777,1028,recall_disagree_votes,129,1805,3247,3286
68000070005,桃園市,龜山區,山福里,桃園市第01選區,牛煦庭,中國國民黨,1009,764,880,recall_disagree_votes,129,1644,2973,3032
66000080027,臺中市,北屯區,平順里,臺中市第05選區,黃健豪,中國國民黨,1057,748,928,recall_disagree_votes,129,1676,3034,3028
65000060034,新北市,新店區,文中里,新北市第11選區,羅明才,中國國民黨,722,255,593,recall_disagree_votes,129,848,1607,1562
68000070004,桃園市,龜山區,大同里,桃園市第01選區,牛煦庭,中國國民黨,1934,1482,1806,recall_disagree_votes,128,3288,5873,5599
65000120007,新北市,瑞芳區,爪峯里,新北市第12選區,廖先翔,中國國民黨,1096,624,968,recall_disagree_votes,128,1592,3264,3357
10009130011,雲林縣,麥寮鄉,施厝村,雲林縣第01選區,丁學忠,中國國民黨,1009,614,881,recall_disagree_votes,128,1495,3497,3534
66000050005,臺中市,北區,新北里,臺中市第05選區,黃健豪,中國國民黨,542,361,415,recall_disagree_votes,127,776,1540,1567
68000070003,桃園市,龜山區,兔坑里,桃園市第01選區,牛煦庭,中國國民黨,1221,903,1094,recall_disagree_votes,127,1997,3840,3801
65000030028,新北市,中和區,秀成里,新北市第09選區,林德福,中國國民黨,1152,667,1025,recall_disagree_votes,127,1692,2886,2932
63000030026,臺北市,大安區,龍陣里,臺北市第06選區,羅智強,中國國民黨,1065,700,938,recall_disagree_votes,127,1638,2762,2821
66000100001,臺中市,東勢區,北興里,臺中市第08選區,江啟臣,中國國民黨,641,149,515,recall_disagree_votes,126,664,1359,1339
66000200001,臺中市,石岡區,石岡里,臺中市第08選區,江啟臣,中國國民黨,505,164,379,recall_disagree_votes,126,543,1101,1135
66000080002,臺中市,北屯區,北屯里,臺中市第05選區,黃健豪,中國國民黨,1227,784,1101,recall_disagree_votes,126,1885,3340,3290
10008030004,南投縣,草屯鎮,敦和里,南投縣第01選區,馬文君,中國國民黨,2176,1022,2050,recall_disagree_votes,126,3072,6054,6203
65000110028,新北市,汐止區,仁德里,新北市第12選區,廖先翔,中國國民黨,651,416,525,recall_disagree_votes,126,941,1629,1634
63000080002,臺北市,文山區,景東里,臺北市第08選區,賴士葆,中國國民黨,2134,1193,2008,recall_disagree_votes,126,3201,5581,5690
10009030009,雲林縣,虎尾鎮,興南里,雲林縣第01選區,丁學忠,中國國民黨,881,444,755,recall_disagree_votes,126,1199,2200,2181
10009050003,雲林縣,土庫鎮,宮北里,雲林縣第01選區,丁學忠,中國國民黨,551,306,425,recall_disagree_votes,126,731,1262,1287
10009130007,雲林縣,麥寮鄉,海豐村,雲林縣第01選區,丁學忠,中國國民黨,757,256,631,recall_disagree_votes,126,887,2140,2193
68000040021,桃園市,楊梅區,豐野里,桃園市第02選區,涂權吉,中國國民黨,1464,794,1339,recall_disagree_votes,125,2133,3714,3755
66000020007,臺中市,東區,旱溪里,臺中市第06選區,羅廷瑋,中國國民黨,864,671,739,recall_disagree_votes,125,1410,2336,2393
63000040005,臺北市,中山區,康樂里,臺北市第03選區,王鴻薇,中國國民黨,837,567,712,recall_disagree_votes,125,1279,2300,2246
10008090006,南投縣,魚池鄉,東光村,南投縣第01選區,馬文君,中國國民黨,407,143,283,recall_disagree_votes,124,426,1136,1167
65000200001,新北市,坪林區,粗窟里,新北市第11選區,羅明才,中國國民黨,271,122,147,recall_disagree_votes,124,269,814,828
10004020015,新竹縣,竹東鎮,三重里,新竹縣第02選區,林思銘,中國國民黨,2251,774,2127,recall_disagree_votes,124,2901,6200,6158
68000050008,桃園市,蘆竹區,錦興里,桃園市第01選區,牛煦庭,中國國民黨,1324,1094,1200,recall_disagree_votes,124,2294,3857,3765
66000020014,臺中市,東區,富台里,臺中市第06選區,羅廷瑋,中國國民黨,771,264,648,recall_disagree_votes,123,912,1612,1634
68000070022,桃園市,龜山區,幸福里,桃園市第01選區,牛煦庭,中國國民黨,1406,907,1283,recall_disagree_votes,123,2190,4405,4434
66000050006,臺中市,北區,樂英里,臺中市第05選區,黃健豪,中國國民黨,1161,315,1038,recall_disagree_votes,123,1353,2363,2381
65000290002,新北市,烏來區,忠治里,新北市第11選區,羅明才,中國國民黨,349,158,226,recall_disagree_votes,123,384,919,957
65000110005,新北市,汐止區,橋東里,新北市第12選區,廖先翔,中國國民黨,1232,787,1109,recall_disagree_votes,123,1896,3291,3202
66000060026,臺中市,西屯區,至善里,臺中市第04選區,廖偉翔,中國國民黨,1543,1046,1421,recall_disagree_votes,122,2467,4344,4278
63000100005,臺北市,內湖區,港墘里,臺北市第04選區,李彥秀,中國國民黨,1677,1298,1555,recall_disagree_votes,122,2853,4722,4854
68000070021,桃園市,龜山區,南美里,桃園市第01選區,牛煦庭,中國國民黨,820,557,698,recall_disagree_votes,122,1255,2199,2241
65000100016,新北市,淡水區,坪頂里,新北市第01選區,洪孟楷,中國國民黨,474,329,352,recall_disagree_votes,122,681,1280,1236
63000030048,臺北市,大安區,黎和里,臺北市第06選區,羅智強,中國國民黨,1587,927,1466,recall_disagree_votes,121,2393,3952,3888
10015050003,花蓮縣,吉安鄉,太昌村,花蓮縣第01選區,傅崐萁,中國國民黨,938,803,817,recall_disagree_votes,121,1620,2772,2814
68000050004,桃園市,蘆竹區,大竹里,桃園市第01選區,牛煦庭,中國國民黨,1827,1413,1706,recall_disagree_votes,121,3119,5463,5277
10008090001,南投縣,魚池鄉,東池村,南投縣第01選區,馬文君,中國國民黨,551,202,430,recall_disagree_votes,121,632,1459,1495
66000200009,臺中市,石岡區,德興里,臺中市第08選區,江啟臣,中國國民黨,631,163,510,recall_disagree_votes,121,673,1296,1316
65000010081,新北市,板橋區,仁愛里,新北市第07選區,葉元之,中國國民黨,1111,582,991,recall_disagree_votes,120,1573,2498,2550
66000050033,臺中市,北區,明新里,臺中市第05選區,黃健豪,中國國民黨,929,657,809,recall_disagree_votes,120,1466,2583,2565
68000040019,桃園市,楊梅區,光華里,桃園市第02選區,涂權吉,中國國民黨,1267,526,1147,recall_disagree_votes,120,1673,2906,2962
68000050017,桃園市,蘆竹區,南榮里,桃園市第01選區,牛煦庭,中國國民黨,1160,976,1040,recall_disagree_votes,120,2016,3582,3479
63000030038,臺北市,大安區,虎嘯里,臺北市第06選區,羅智強,中國國民黨,1165,741,1045,recall_disagree_votes,120,1786,3013,3023
65000040037,新北市,永和區,復興里,新北市第09選區,林德福,中國國民黨,879,435,760,recall_disagree_votes,119,1195,2043,2035
66000030016,臺中市,南區,長榮里,臺中市第06選區,羅廷瑋,中國國民黨,865,665,746,recall_disagree_votes,119,1411,2268,2272
68000010019,桃園市,桃園區,西門里,桃園市第04選區,萬美玲,中國國民黨,591,428,472,recall_disagree_votes,119,900,1750,1710
65000040024,新北市,永和區,雙和里,新北市第09選區,林德福,中國國民黨,1338,781,1219,recall_disagree_votes,119,2000,3281,3261
65000040045,新北市,永和區,新廍里,新北市第09選區,林德福,中國國民黨,850,429,732,recall_disagree_votes,118,1161,1895,1903
68000010003,桃園市,桃園區,武陵里,桃園市第04選區,萬美玲,中國國民黨,528,350,411,recall_disagree_votes,117,761,1736,1636
63000030033,臺北市,大安區,臨江里,臺北市第06選區,羅智強,中國國民黨,1207,864,1090,recall_disagree_votes,117,1954,3354,3400
66000230015,臺中市,烏日區,南里里,臺中市第02選區,顏寬恒,中國國民黨,613,206,496,recall_disagree_votes,117,702,1263,1303
10008030013,南投縣,草屯鎮,新庄里,南投縣第01選區,馬文君,中國國民黨,1292,595,1175,recall_disagree_votes,117,1770,3627,3615
66000050020,臺中市,北區,錦祥里,臺中市第05選區,黃健豪,中國國民黨,1817,1194,1701,recall_disagree_votes,116,2895,5387,4914
68000010002,桃園市,桃園區,文明里,桃園市第04選區,萬美玲,中國國民黨,578,382,462,recall_disagree_votes,116,844,1450,1473
63000090019,臺北市,南港區,仁福里,臺北市第04選區,李彥秀,中國國民黨,1923,1005,1807,recall_disagree_votes,116,2812,4478,4574
68000040010,桃園市,楊梅區,大同里,桃園市第02選區,涂權吉,中國國民黨,1563,639,1447,recall_disagree_votes,116,2086,3411,3430
66000230005,臺中市,烏日區,學田里,臺中市第02選區,顏寬恒,中國國民黨,954,443,838,recall_disagree_votes,116,1281,2466,2494
66000060012,臺中市,西屯區,大石里,臺中市第04選區,廖偉翔,中國國民黨,1229,227,1113,recall_disagree_votes,116,1340,2168,2074
65000170011,新北市,林口區,下福里,新北市第01選區,洪孟楷,中國國民黨,463,298,347,recall_disagree_votes,116,645,1135,1165
10008020013,南投縣,埔里鎮,珠格里,南投縣第01選區,馬文君,中國國民黨,423,162,308,recall_disagree_votes,115,470,1025,1059
10008130009,南投縣,仁愛鄉,大同村,南投縣第01選區,馬文君,中國國民黨,499,98,384,recall_disagree_votes,115,482,1033,1100
66000100009,臺中市,東勢區,中嵙里,臺中市第08選區,江啟臣,中國國民黨,805,197,690,recall_disagree_votes,115,887,1746,1757
10009030023,雲林縣,虎尾鎮,惠來里,雲林縣第01選區,丁學忠,中國國民黨,843,451,728,recall_disagree_votes,115,1179,2237,2241
65000040032,新北市,永和區,大新里,新北市第09選區,林德福,中國國民黨,953,456,838,recall_disagree_votes,115,1294,2232,2227
68000050038,桃園市,蘆竹區,營福里,桃園市第01選區,牛煦庭,中國國民黨,1052,732,938,recall_disagree_votes,114,1670,3149,3091
66000130013,臺中市,沙鹿區,晉江里,臺中市第02選區,顏寬恒,中國國民黨,732,314,618,recall_disagree_votes,114,932,1814,1730
66000260005,臺中市,霧峰區,中正里,臺中市第02選區,顏寬恒,中國國民黨,755,390,641,recall_disagree_votes,114,1031,1879,1912
65000060031,新北市,新店區,新店里,新北市第11選區,羅明才,中國國民黨,555,364,441,recall_disagree_votes,114,805,1564,1582
65000040043,新北市,永和區,前溪里,新北市第09選區,林德福,中國國民黨,776,375,662,recall_disagree_votes,114,1037,1782,1838
66000130001,臺中市,沙鹿區,居仁里,臺中市第02選區,顏寬恒,中國國民黨,469,241,356,recall_disagree_votes,113,597,1229,1251
66000230014,臺中市,烏日區,北里里,臺中市第02選區,顏寬恒,中國國民黨,594,312,481,recall_disagree_votes,113,793,1553,1570
10004090003,新竹縣,北埔鄉,埔尾村,新竹縣第02選區,林思銘,中國國民黨,934,271,821,recall_disagree_votes,113,1092,2387,2435
66000150015,臺中市,后里區,泰安里,臺中市第03選區,楊瓊瓔,中國國民黨,521,214,408,recall_disagree_votes,113,622,1342,1375
66000100025,臺中市,東勢區,明正里,臺中市第08選區,江啟臣,中國國民黨,500,165,387,recall_disagree_votes,113,552,1251,1273
66000100017,臺中市,東勢區,慶福里,臺中市第08選區,江啟臣,中國國民黨,458,125,346,recall_disagree_votes,112,471,1119,1167
66000260020,臺中市,霧峰區,南勢里,臺中市第02選區,顏寬恒,中國國民黨,508,207,396,recall_disagree_votes,112,603,1212,1234
68000020034,桃園市,中壢區,文化里,桃園市第03選區,魯明哲,中國國民黨,2837,1822,2725,recall_disagree_votes,112,4547,8309,8422
66000290003,臺中市,和平區,博愛里,臺中市第08選區,江啟臣,中國國民黨,377,58,265,recall_disagree_votes,112,323,826,852
65000030021,新北市,中和區,安和里,新北市第09選區,林德福,中國國民黨,1069,686,957,recall_disagree_votes,112,1643,2652,2643
10009130013,雲林縣,麥寮鄉,中興村,雲林縣第01選區,丁學忠,中國國民黨,537,207,425,recall_disagree_votes,112,632,1502,1541
65000100031,新北市,淡水區,文化里,新北市第01選區,洪孟楷,中國國民黨,644,331,533,recall_disagree_votes,111,864,1533,1520
63000090009,臺北市,南港區,玉成里,臺北市第04選區,李彥秀,中國國民黨,1299,1029,1188,recall_disagree_votes,111,2217,3727,3857
10008040006,南投縣,竹山鎮,下坪里,南投縣第02選區,游顥,中國國民黨,440,182,329,recall_disagree_votes,111,511,1148,1150
65000220009,新北市,石門區,草里里,新北市第01選區,洪孟楷,中國國民黨,344,141,233,recall_disagree_votes,111,374,838,872
63000030046,臺北市,大安區,黎元里,臺北市第06選區,羅智強,中國國民黨,1625,1089,1514,recall_disagree_votes,111,2603,4352,4456
65000040009,新北市,永和區,永成里,新北市第09選區,林德福,中國國民黨,451,74,341,recall_disagree_votes,110,415,781,862
65000110013,新北市,汐止區,鄉長里,新北市第12選區,廖先翔,中國國民黨,753,526,643,recall_disagree_votes,110,1169,1986,2059
66000070005,臺中市,南屯區,春社里,臺中市第04選區,廖偉翔,中國國民黨,2145,1351,2035,recall_disagree_votes,110,3386,6419,6281
66000100006,臺中市,東勢區,上新里,臺中市第08選區,江啟臣,中國國民黨,483,113,374,recall_disagree_votes,109,487,857,899
68000010058,桃園市,桃園區,寶山里,桃園市第01選區,牛煦庭,中國國民黨,1479,999,1371,recall_disagree_votes,108,2370,4132,4091
68000010006,桃園市,桃園區,會稽里,桃園市第01選區,牛煦庭,中國國民黨,1391,786,1283,recall_disagree_votes,108,2069,3722,3652
68000040029,桃園市,楊梅區,裕成里,桃園市第02選區,涂權吉,中國國民黨,1417,623,1309,recall_disagree_votes,108,1932,3085,3116
65000100002,新北市,淡水區,屯山里,新北市第01選區,洪孟楷,中國國民黨,356,249,248,recall_disagree_votes,108,497,900,918
68000070018,桃園市,龜山區,舊路里,桃園市第01選區,牛煦庭,中國國民黨,959,683,851,recall_disagree_votes,108,1534,2705,2618
10009130005,雲林縣,麥寮鄉,崙後村,雲林縣第01選區,丁學忠,中國國民黨,847,390,740,recall_disagree_votes,107,1130,2696,2767
65000040053,新北市,永和區,正興里,新北市第09選區,林德福,中國國民黨,744,401,637,recall_disagree_votes,107,1038,1889,1889
10017060014,基隆市,安樂區,新崙里,基隆市第01選區,林沛祥,中國國民黨,1385,800,1279,recall_disagree_votes,106,2079,3921,3847
66000250014,臺中市,龍井區,南寮里,臺中市第02選區,顏寬恒,中國國民黨,666,247,560,recall_disagree_votes,106,807,1373,1470
65000030077,新北市,中和區,秀士里,新北市第09選區,林德福,中國國民黨,903,374,797,recall_disagree_votes,106,1171,2163,2165
10008020027,南投縣,埔里鎮,大湳里,南投縣第01選區,馬文君,中國國民黨,603,288,498,recall_disagree_votes,105,786,1672,1639
66000260004,臺中市,霧峰區,本鄉里,臺中市第02選區,顏寬恒,中國國民黨,835,435,730,recall_disagree_votes,105,1165,2157,2202
66000250005,臺中市,龍井區,福田里,臺中市第02選區,顏寬恒,中國國民黨,454,126,349,recall_disagree_votes,105,475,955,1004
68000050024,桃園市,蘆竹區,瓦窯里,桃園市第01選區,牛煦庭,中國國民黨,1215,717,1111,recall_disagree_votes,104,1828,3429,3286
65000110040,新北市,汐止區,山光里,新北市第12選區,廖先翔,中國國民黨,1007,576,903,recall_disagree_votes,104,1479,2804,2542
66000050024,臺中市,北區,賴明里,臺中市第05選區,黃健豪,中國國民黨,1329,825,1225,recall_disagree_votes,104,2050,3607,3567
63000100028,臺北市,內湖區,石潭里,臺北市第04選區,李彥秀,中國國民黨,1192,751,1089,recall_disagree_votes,103,1840,3334,3402
68000050034,桃園市,蘆竹區,福祿里,桃園市第01選區,牛煦庭,中國國民黨,1024,746,921,recall_disagree_votes,103,1667,3063,3056
10008020023,南投縣,埔里鎮,廣成里,南投縣第01選區,馬文君,中國國民黨,451,147,348,recall_disagree_votes,103,495,1039,1072
63000090002,臺北市,南港區,中南里,臺北市第04選區,李彥秀,中國國民黨,927,725,824,recall_disagree_votes,103,1549,2751,2876
66000190013,臺中市,新社區,福興里,臺中市第08選區,江啟臣,中國國民黨,493,117,391,recall_disagree_votes,102,508,1010,1072
68000050020,桃園市,蘆竹區,錦中里,桃園市第01選區,牛煦庭,中國國民黨,1033,831,932,recall_disagree_votes,101,1763,3147,3107
63000020021,臺北市,信義區,松隆里,臺北市第07選區,徐巧芯,中國國民黨,633,412,532,recall_disagree_votes,101,944,1686,1790
10009130012,雲林縣,麥寮鄉,雷厝村,雲林縣第01選區,丁學忠,中國國民黨,635,354,534,recall_disagree_votes,101,888,2220,2204
65000100005,新北市,淡水區,蕃薯里,新北市第01選區,洪孟楷,中國國民黨,373,193,272,recall_disagree_votes,101,465,978,971
65000030035,新北市,中和區,華新里,新北市第08選區,張智倫,中國國民黨,2339,1558,2238,recall_disagree_votes,101,3796,6843,6764
66000100021,臺中市,東勢區,興隆里,臺中市第08選區,江啟臣,中國國民黨,409,174,308,recall_disagree_votes,101,482,1122,1120
65000110011,新北市,汐止區,保安里,新北市第12選區,廖先翔,中國國民黨,516,309,416,recall_disagree_votes,100,725,1408,1437
10008030022,南投縣,草屯鎮,雙冬里,南投縣第01選區,馬文君,中國國民黨,714,269,614,recall_disagree_votes,100,883,2087,2151
68000040030,桃園市,楊梅區,秀才里,桃園市第02選區,涂權吉,中國國民黨,1269,707,1169,recall_disagree_votes,100,1876,3181,3212
10009030025,雲林縣,虎尾鎮,中溪里,雲林縣第01選區,丁學忠,中國國民黨,562,284,462,recall_disagree_votes,100,746,1244,1264
65000060053,新北市,新店區,和平里,新北市第11選區,羅明才,中國國民黨,606,174,507,recall_disagree_votes,99,681,1418,1372
66000130010,臺中市,沙鹿區,犁分里,臺中市第02選區,顏寬恒,中國國民黨,398,187,299,recall_disagree_votes,99,486,1047,1066
65000210003,新北市,三芝區,古庄里,新北市第01選區,洪孟楷,中國國民黨,421,225,322,recall_disagree_votes,99,547,1146,1106
66000150002,臺中市,后里區,仁里里,臺中市第03選區,楊瓊瓔,中國國民黨,443,108,344,recall_disagree_votes,99,452,947,976
10009050010,雲林縣,土庫鎮,石廟里,雲林縣第01選區,丁學忠,中國國民黨,1050,615,951,recall_disagree_votes,99,1566,3024,2886
10004080009,新竹縣,橫山鄉,新興村,新竹縣第02選區,林思銘,中國國民黨,654,145,556,recall_disagree_votes,98,701,1416,1449
10008030006,南投縣,草屯鎮,富寮里,南投縣第01選區,馬文君,中國國民黨,2249,1321,2151,recall_disagree_votes,98,3472,7169,6755
68000050016,桃園市,蘆竹區,海湖里,桃園市第01選區,牛煦庭,中國國民黨,786,543,688,recall_disagree_votes,98,1231,2518,2584
68000050033,桃園市,蘆竹區,中山里,桃園市第01選區,牛煦庭,中國國民黨,1138,795,1040,recall_disagree_votes,98,1835,3371,3307
65000110010,新北市,汐止區,長安里,新北市第12選區,廖先翔,中國國民黨,512,358,415,recall_disagree_votes,97,773,1385,1458
65000100027,新北市,淡水區,協元里,新北市第01選區,洪孟楷,中國國民黨,422,345,325,recall_disagree_votes,97,670,1231,1259
66000200008,臺中市,石岡區,土牛里,臺中市第08選區,江啟臣,中國國民黨,456,135,359,recall_disagree_votes,97,494,975,979
65000040005,新北市,永和區,仁愛里,新北市第09選區,林德福,中國國民黨,947,570,851,recall_disagree_votes,96,1421,2340,2343
65000110018,新北市,汐止區,樟樹里,新北市第12選區,廖先翔,中國國民黨,635,439,539,recall_disagree_votes,96,978,1856,1890
10017060025,基隆市,安樂區,壯觀里,基隆市第01選區,林沛祥,中國國民黨,1664,861,1568,recall_disagree_votes,96,2429,4271,4192
10008100007,南投縣,國姓鄉,福龜村,南投縣第01選區,馬文君,中國國民黨,672,207,576,recall_disagree_votes,96,783,1619,1663
68000010079,桃園市,桃園區,福元里,桃園市第01選區,牛煦庭,中國國民黨,1754,1106,1658,recall_disagree_votes,96,2764,4943,4535
66000050007,臺中市,北區,錦村里,臺中市第05選區,黃健豪,中國國民黨,1143,707,1048,recall_disagree_votes,95,1755,2868,2943
68000040017,桃園市,楊梅區,高榮里,桃園市第02選區,涂權吉,中國國民黨,1167,823,1072,recall_disagree_votes,95,1895,3347,3317
65000040042,新北市,永和區,大同里,新北市第09選區,林德福,中國國民黨,441,120,346,recall_disagree_votes,95,466,839,923
66000040024,臺中市,西區,双龍里,臺中市第06選區,羅廷瑋,中國國民黨,909,665,814,recall_disagree_votes,95,1479,2563,2614
65000010075,新北市,板橋區,景星里,新北市第07選區,葉元之,中國國民黨,1030,817,935,recall_disagree_votes,95,1752,3080,3016
10008020018,南投縣,埔里鎮,愛蘭里,南投縣第01選區,馬文君,中國國民黨,533,182,438,recall_disagree_votes,95,620,1286,1273
66000060019,臺中市,西屯區,福安里,臺中市第04選區,廖偉翔,中國國民黨,1086,777,991,recall_disagree_votes,95,1768,3055,2939
66000090011,臺中市,豐原區,東勢里,臺中市第08選區,江啟臣,中國國民黨,485,282,390,recall_disagree_votes,95,672,1315,1356
10004100010,新竹縣,寶山鄉,雙新村,新竹縣第02選區,林思銘,中國國民黨,877,327,782,recall_disagree_votes,95,1109,2644,2642
66000190010,臺中市,新社區,東興里,臺中市第08選區,江啟臣,中國國民黨,524,131,430,recall_disagree_votes,94,561,1170,1155
63000100007,臺北市,內湖區,港富里,臺北市第04選區,李彥秀,中國國民黨,2530,2076,2436,recall_disagree_votes,94,4512,7559,7676
68000040024,桃園市,楊梅區,三湖里,桃園市第02選區,涂權吉,中國國民黨,1121,593,1027,recall_disagree_votes,94,1620,2929,2830
10008090003,南投縣,魚池鄉,中明村,南投縣第01選區,馬文君,中國國民黨,344,128,250,recall_disagree_votes,94,378,891,908
10008070003,南投縣,鹿谷鄉,彰雅村,南投縣第02選區,游顥,中國國民黨,550,140,456,recall_disagree_votes,94,596,1169,1216
10015040006,花蓮縣,新城鄉,嘉里村,花蓮縣第01選區,傅崐萁,中國國民黨,973,604,880,recall_disagree_votes,93,1484,2582,2638
66000230010,臺中市,烏日區,光明里,臺中市第02選區,顏寬恒,中國國民黨,741,409,648,recall_disagree_votes,93,1057,1982,2011
10015030001,花蓮縣,玉里鎮,中城里,花蓮縣第01選區,傅崐萁,中國國民黨,1613,949,1520,recall_disagree_votes,93,2469,4208,4221
10009030013,雲林縣,虎尾鎮,三合里,雲林縣第01選區,丁學忠,中國國民黨,617,242,525,recall_disagree_votes,92,767,1344,1292
63000090013,臺北市,南港區,鴻福里,臺北市第04選區,李彥秀,中國國民黨,1368,917,1276,recall_disagree_votes,92,2193,3571,3707
10008020009,南投縣,埔里鎮,籃城里,南投縣第01選區,馬文君,中國國民黨,361,193,269,recall_disagree_votes,92,462,894,905
66000100003,臺中市,東勢區,東安里,臺中市第08選區,江啟臣,中國國民黨,463,114,371,recall_disagree_votes,92,485,926,957
66000240013,臺中市,大肚區,山陽里,臺中市第02選區,顏寬恒,中國國民黨,504,214,412,recall_disagree_votes,92,626,1256,1254
66000260006,臺中市,霧峰區,錦榮里,臺中市第02選區,顏寬恒,中國國民黨,492,220,400,recall_disagree_votes,92,620,1238,1217
65000030076,新北市,中和區,秀義里,新北市第09選區,林德福,中國國民黨,897,539,805,recall_disagree_votes,92,1344,2314,2322
63000050010,臺北市,中正區,螢雪里,臺北市第08選區,賴士葆,中國國民黨,1137,778,1045,recall_disagree_votes,92,1823,3288,3430
66000050012,臺中市,北區,邱厝里,臺中市第05選區,黃健豪,中國國民黨,759,535,668,recall_disagree_votes,91,1203,2121,2155
66000190004,臺中市,新社區,月湖里,臺中市第08選區,江啟臣,中國國民黨,395,138,304,recall_disagree_votes,91,442,962,958
65000100024,新北市,淡水區,長庚里,新北市第01選區,洪孟楷,中國國民黨,518,325,427,recall_disagree_votes,91,752,1238,1266
63000050004,臺北市,中正區,林興里,臺北市第08選區,賴士葆,中國國民黨,1366,847,1276,recall_disagree_votes,90,2123,3868,3905
66000190008,臺中市,新社區,中興里,臺中市第08選區,江啟臣,中國國民黨,346,49,256,recall_disagree_votes,90,305,559,579
63000100040,臺北市,內湖區,南湖里,臺北市第04選區,李彥秀,中國國民黨,1633,1143,1543,recall_disagree_votes,90,2686,4375,4481
65000030074,新北市,中和區,宜安里,新北市第09選區,林德福,中國國民黨,779,388,690,recall_disagree_votes,89,1078,1805,1779
10004020014,新竹縣,竹東鎮,五豐里,新竹縣第02選區,林思銘,中國國民黨,2374,734,2285,recall_disagree_votes,89,3019,6994,6859
65000040022,新北市,永和區,上溪里,新北市第09選區,林德福,中國國民黨,641,397,552,recall_disagree_votes,89,949,1688,1632
10008030012,南投縣,草屯鎮,上林里,南投縣第01選區,馬文君,中國國民黨,1215,538,1126,recall_disagree_votes,89,1664,3063,3080
65000120002,新北市,瑞芳區,龍興里,新北市第12選區,廖先翔,中國國民黨,645,358,556,recall_disagree_votes,89,914,1764,1778
66000200004,臺中市,石岡區,金星里,臺中市第08選區,江啟臣,中國國民黨,482,153,393,recall_disagree_votes,89,546,1126,1162
66000030015,臺中市,南區,長春里,臺中市第06選區,羅廷瑋,中國國民黨,626,489,537,recall_disagree_votes,89,1026,1729,1774
65000220004,新北市,石門區,山溪里,新北市第01選區,洪孟楷,中國國民黨,335,126,247,recall_disagree_votes,88,373,762,821
10004020007,新竹縣,竹東鎮,大鄉里,新竹縣第02選區,林思銘,中國國民黨,1580,440,1492,recall_disagree_votes,88,1932,4231,4317
10008100010,南投縣,國姓鄉,北山村,南投縣第01選區,馬文君,中國國民黨,487,179,399,recall_disagree_votes,88,578,1321,1366
63000100009,臺北市,內湖區,內湖里,臺北市第04選區,李彥秀,中國國民黨,1986,1390,1898,recall_disagree_votes,88,3288,5591,5470
68000040003,桃園市,楊梅區,紅梅里,桃園市第02選區,涂權吉,中國國民黨,1069,551,981,recall_disagree_votes,88,1532,2545,2465
65000110009,新北市,汐止區,茄苳里,新北市第12選區,廖先翔,中國國民黨,1358,976,1271,recall_disagree_votes,87,2247,4288,3902
65000200005,新北市,坪林區,上德里,新北市第11選區,羅明才,中國國民黨,266,137,179,recall_disagree_votes,87,316,798,811
10008080010,南投縣,中寮鄉,永福村,南投縣第01選區,馬文君,中國國民黨,486,153,399,recall_disagree_votes,87,552,1240,1252
65000100028,新北市,淡水區,永吉里,新北市第01選區,洪孟楷,中國國民黨,323,206,236,recall_disagree_votes,87,442,759,767
10008100004,南投縣,國姓鄉,北港村,南投縣第01選區,馬文君,中國國民黨,617,200,530,recall_disagree_votes,87,730,1657,1725
10004020009,新竹縣,竹東鎮,商華里,新竹縣第02選區,林思銘,中國國民黨,874,242,788,recall_disagree_votes,86,1030,2613,2616
63000100035,臺北市,內湖區,康寧里,臺北市第04選區,李彥秀,中國國民黨,2368,1619,2282,recall_disagree_votes,86,3901,6603,6738
65000160001,新北市,泰山區,大科里,新北市第01選區,洪孟楷,中國國民黨,267,201,181,recall_disagree_votes,86,382,720,751
68000020007,桃園市,中壢區,光明里,桃園市第03選區,魯明哲,中國國民黨,1864,1089,1778,recall_disagree_votes,86,2867,5130,5177
65000040019,新北市,永和區,勵行里,新北市第09選區,林德福,中國國民黨,384,271,298,recall_disagree_votes,86,569,1047,1053
66000060007,臺中市,西屯區,逢甲里,臺中市第04選區,廖偉翔,中國國民黨,1602,1074,1516,recall_disagree_votes,86,2590,4587,4506
10009060015,雲林縣,北港鎮,光復里,雲林縣第01選區,丁學忠,中國國民黨,578,358,492,recall_disagree_votes,86,850,1601,1589
66000290004,臺中市,和平區,中坑里,臺中市第08選區,江啟臣,中國國民黨,246,49,161,recall_disagree_votes,85,210,421,442
10004020016,新竹縣,竹東鎮,頭重里,新竹縣第02選區,林思銘,中國國民黨,1633,634,1548,recall_disagree_votes,85,2182,4470,4449
66000200005,臺中市,石岡區,龍興里,臺中市第08選區,江啟臣,中國國民黨,286,62,202,recall_disagree_votes,84,264,593,603
65000210013,新北市,三芝區,興華里,新北市第01選區,洪孟楷,中國國民黨,396,267,312,recall_disagree_votes,84,579,1110,1126
66000090017,臺中市,豐原區,圳寮里,臺中市第08選區,江啟臣,中國國民黨,461,269,377,recall_disagree_votes,84,646,1140,1179
66000080001,臺中市,北屯區,北興里,臺中市第05選區,黃健豪,中國國民黨,1158,766,1074,recall_disagree_votes,84,1840,3041,3134
66000230013,臺中市,烏日區,螺潭里,臺中市第02選區,顏寬恒,中國國民黨,831,414,747,recall_disagree_votes,84,1161,2115,2089
63000100013,臺北市,內湖區,金龍里,臺北市第04選區,李彥秀,中國國民黨,1583,1104,1500,recall_disagree_votes,83,2604,4304,4451
68000040033,桃園市,楊梅區,雙榮里,桃園市第02選區,涂權吉,中國國民黨,1221,798,1138,recall_disagree_votes,83,1936,3123,3148
10008030026,南投縣,草屯鎮,明正里,南投縣第01選區,馬文君,中國國民黨,1255,592,1172,recall_disagree_votes,83,1764,3481,3525
68000010008,桃園市,桃園區,民生里,桃園市第04選區,萬美玲,中國國民黨,596,391,514,recall_disagree_votes,82,905,1717,1662
65000110001,新北市,汐止區,義民里,新北市第12選區,廖先翔,中國國民黨,432,272,350,recall_disagree_votes,82,622,1096,1165
10008100001,南投縣,國姓鄉,國姓村,南投縣第01選區,馬文君,中國國民黨,584,202,502,recall_disagree_votes,82,704,1492,1561
10017060022,基隆市,安樂區,長樂里,基隆市第01選區,林沛祥,中國國民黨,1381,673,1300,recall_disagree_votes,81,1973,3201,3205
65000120034,新北市,瑞芳區,新峰里,新北市第12選區,廖先翔,中國國民黨,895,487,814,recall_disagree_votes,81,1301,2763,2781
10008090004,南投縣,魚池鄉,新城村,南投縣第01選區,馬文君,中國國民黨,434,188,353,recall_disagree_votes,81,541,1214,1252
10009030011,雲林縣,虎尾鎮,穎川里,雲林縣第01選區,丁學忠,中國國民黨,839,397,758,recall_disagree_votes,81,1155,2005,1965
66000160016,臺中市,神岡區,山皮里,臺中市第03選區,楊瓊瓔,中國國民黨,392,204,311,recall_disagree_votes,81,515,1022,968
65000110025,新北市,汐止區,宜興里,新北市第12選區,廖先翔,中國國民黨,1039,549,959,recall_disagree_votes,80,1508,2587,2599
10008040017,南投縣,竹山鎮,中央里,南投縣第02選區,游顥,中國國民黨,372,166,292,recall_disagree_votes,80,458,994,1040
10008070001,南投縣,鹿谷鄉,鹿谷村,南投縣第02選區,游顥,中國國民黨,622,239,542,recall_disagree_votes,80,781,1731,1751
66000260011,臺中市,霧峰區,南柳里,臺中市第02選區,顏寬恒,中國國民黨,700,337,620,recall_disagree_votes,80,957,1828,1839
10008020020,南投縣,埔里鎮,房里里,南投縣第01選區,馬文君,中國國民黨,553,177,473,recall_disagree_votes,80,650,1225,1240
10017060016,基隆市,安樂區,四維里,基隆市第01選區,林沛祥,中國國民黨,1724,1055,1644,recall_disagree_votes,80,2699,4329,4428
10008070002,南投縣,鹿谷鄉,初鄉村,南投縣第02選區,游顥,中國國民黨,507,155,428,recall_disagree_votes,79,583,1278,1328
65000220001,新北市,石門區,德茂里,新北市第01選區,洪孟楷,中國國民黨,375,193,296,recall_disagree_votes,79,489,1014,1044
10008040018,南投縣,竹山鎮,富州里,南投縣第02選區,游顥,中國國民黨,259,79,181,recall_disagree_votes,78,260,558,564
66000100023,臺中市,東勢區,泰興里,臺中市第08選區,江啟臣,中國國民黨,317,87,239,recall_disagree_votes,78,326,689,681
10008040009,南投縣,竹山鎮,中崎里,南投縣第02選區,游顥,中國國民黨,494,210,416,recall_disagree_votes,78,626,1368,1373
66000100002,臺中市,東勢區,中寧里,臺中市第08選區,江啟臣,中國國民黨,392,71,315,recall_disagree_votes,77,386,761,774
65000210004,新北市,三芝區,新庄里,新北市第01選區,洪孟楷,中國國民黨,315,154,238,recall_disagree_votes,77,392,700,748
66000290006,臺中市,和平區,達觀里,臺中市第08選區,江啟臣,中國國民黨,260,57,183,recall_disagree_votes,77,240,566,597
68000040018,桃園市,楊梅區,仁美里,桃園市第02選區,涂權吉,中國國民黨,1539,778,1462,recall_disagree_votes,77,2240,3729,3687
68000050029,桃園市,蘆竹區,福興里,桃園市第01選區,牛煦庭,中國國民黨,1155,810,1078,recall_disagree_votes,77,1888,3491,3417
68000010047,桃園市,桃園區,春日里,桃園市第01選區,牛煦庭,中國國民黨,1858,1431,1781,recall_disagree_votes,77,3212,5849,5834
66000050029,臺中市,北區,錦平里,臺中市第05選區,黃健豪,中國國民黨,561,470,484,recall_disagree_votes,77,954,1835,1804
10004110006,新竹縣,峨眉鄉,湖光村,新竹縣第02選區,林思銘,中國國民黨,333,109,256,recall_disagree_votes,77,365,809,839
10008020022,南投縣,埔里鎮,一新里,南投縣第01選區,馬文君,中國國民黨,524,111,447,recall_disagree_votes,77,558,933,934
66000080022,臺中市,北屯區,仁愛里,臺中市第05選區,黃健豪,中國國民黨,421,212,344,recall_disagree_votes,77,556,985,1005
66000050004,臺中市,北區,新興里,臺中市第05選區,黃健豪,中國國民黨,534,255,458,recall_disagree_votes,76,713,1303,1368
10009030026,雲林縣,虎尾鎮,下溪里,雲林縣第01選區,丁學忠,中國國民黨,688,262,612,recall_disagree_votes,76,874,1419,1435
10004080001,新竹縣,橫山鄉,橫山村,新竹縣第02選區,林思銘,中國國民黨,1208,302,1132,recall_disagree_votes,76,1434,3070,3112
10008100005,南投縣,國姓鄉,長流村,南投縣第01選區,馬文君,中國國民黨,497,130,421,recall_disagree_votes,76,551,1213,1265
10008040013,南投縣,竹山鎮,延山里,南投縣第02選區,游顥,中國國民黨,274,147,199,recall_disagree_votes,75,346,763,770
68000040009,桃園市,楊梅區,梅新里,桃園市第02選區,涂權吉,中國國民黨,773,388,698,recall_disagree_votes,75,1086,1849,1898
65000110050,新北市,汐止區,保新里,新北市第12選區,廖先翔,中國國民黨,966,514,891,recall_disagree_votes,75,1405,2707,2566
10008080011,南投縣,中寮鄉,義和村,南投縣第01選區,馬文君,中國國民黨,354,147,279,recall_disagree_votes,75,426,987,1003
68000040025,桃園市,楊梅區,上湖里,桃園市第02選區,涂權吉,中國國民黨,2092,1078,2017,recall_disagree_votes,75,3095,6076,5870
66000240004,臺中市,大肚區,營埔里,臺中市第02選區,顏寬恒,中國國民黨,609,240,534,recall_disagree_votes,75,774,1430,1436
65000190008,新北市,石碇區,中民里,新北市第11選區,羅明才,中國國民黨,229,124,154,recall_disagree_votes,75,278,687,685
66000260007,臺中市,霧峰區,萊園里,臺中市第02選區,顏寬恒,中國國民黨,372,197,297,recall_disagree_votes,75,494,964,983
10008100009,南投縣,國姓鄉,柑林村,南投縣第01選區,馬文君,中國國民黨,465,116,391,recall_disagree_votes,74,507,1027,1057
68000040011,桃園市,楊梅區,埔心里,桃園市第02選區,涂權吉,中國國民黨,498,357,424,recall_disagree_votes,74,781,1235,1297
66000020005,臺中市,東區,干城里,臺中市第06選區,羅廷瑋,中國國民黨,779,655,705,recall_disagree_votes,74,1360,2360,2075
68000050027,桃園市,蘆竹區,順興里,桃園市第01選區,牛煦庭,中國國民黨,1310,971,1236,recall_disagree_votes,74,2207,4004,3977
66000230016,臺中市,烏日區,溪尾里,臺中市第02選區,顏寬恒,中國國民黨,393,90,319,recall_disagree_votes,74,409,797,793
10004080010,新竹縣,橫山鄉,大肚村,新竹縣第02選區,林思銘,中國國民黨,678,147,605,recall_disagree_votes,73,752,1597,1597
66000090005,臺中市,豐原區,下街里,臺中市第08選區,江啟臣,中國國民黨,309,139,236,recall_disagree_votes,73,375,689,738
10009030022,雲林縣,虎尾鎮,廉使里,雲林縣第01選區,丁學忠,中國國民黨,1355,902,1282,recall_disagree_votes,73,2184,3874,3623
68000010039,桃園市,桃園區,朝陽里,桃園市第04選區,萬美玲,中國國民黨,622,517,549,recall_disagree_votes,73,1066,1892,1894
10008070006,南投縣,鹿谷鄉,竹林村,南投縣第02選區,游顥,中國國民黨,527,178,454,recall_disagree_votes,73,632,1351,1368
66000090035,臺中市,豐原區,翁社里,臺中市第08選區,江啟臣,中國國民黨,791,352,719,recall_disagree_votes,72,1071,1940,1953
65000040057,新北市,永和區,信義里,新北市第09選區,林德福,中國國民黨,833,520,761,recall_disagree_votes,72,1281,2201,2233
63000080025,臺北市,文山區,明義里,臺北市第08選區,賴士葆,中國國民黨,1068,556,996,recall_disagree_votes,72,1552,2934,3262
10009030014,雲林縣,虎尾鎮,北溪里,雲林縣第01選區,丁學忠,中國國民黨,380,155,309,recall_disagree_votes,71,464,804,811
65000100015,新北市,淡水區,樹興里,新北市第01選區,洪孟楷,中國國民黨,475,391,404,recall_disagree_votes,71,795,1664,1441
10009030021,雲林縣,虎尾鎮,興中里,雲林縣第01選區,丁學忠,中國國民黨,661,312,590,recall_disagree_votes,71,902,1618,1584
65000010107,新北市,板橋區,富貴里,新北市第07選區,葉元之,中國國民黨,689,579,618,recall_disagree_votes,71,1197,1954,1976
63000080017,臺北市,文山區,興業里,臺北市第08選區,賴士葆,中國國民黨,1713,833,1642,recall_disagree_votes,71,2475,4213,4376
10017060019,基隆市,安樂區,七賢里,基隆市第01選區,林沛祥,中國國民黨,735,499,665,recall_disagree_votes,70,1164,2155,2250
10008100008,南投縣,國姓鄉,乾溝村,南投縣第01選區,馬文君,中國國民黨,273,101,203,recall_disagree_votes,70,304,689,721
65000110016,新北市,汐止區,烘內里,新北市第12選區,廖先翔,中國國民黨,505,342,435,recall_disagree_votes,70,777,1437,1436
10008090011,南投縣,魚池鄉,頭社村,南投縣第01選區,馬文君,中國國民黨,275,92,205,recall_disagree_votes,70,297,818,854
66000040011,臺中市,西區,民龍里,臺中市第06選區,羅廷瑋,中國國民黨,1246,996,1176,recall_disagree_votes,70,2172,3875,3432
10008110008,南投縣,水里鄉,永豐村,南投縣第02選區,游顥,中國國民黨,425,181,356,recall_disagree_votes,69,537,1189,1237
68000020029,桃園市,中壢區,龍岡里,桃園市第03選區,魯明哲,中國國民黨,1812,729,1743,recall_disagree_votes,69,2472,4199,4293
65000040052,新北市,永和區,網溪里,新北市第09選區,林德福,中國國民黨,406,188,337,recall_disagree_votes,69,525,971,990
66000010007,臺中市,中區,大誠里,臺中市第06選區,羅廷瑋,中國國民黨,720,573,651,recall_disagree_votes,69,1224,2253,2194
10008090005,南投縣,魚池鄉,大林村,南投縣第01選區,馬文君,中國國民黨,321,172,252,recall_disagree_votes,69,424,974,1010
63000100021,臺北市,內湖區,瑞光里,臺北市第04選區,李彥秀,中國國民黨,1486,853,1417,recall_disagree_votes,69,2270,3561,3677
66000260001,臺中市,霧峰區,桐林里,臺中市第02選區,顏寬恒,中國國民黨,497,186,429,recall_disagree_votes,68,615,1182,1166
10017060015,基隆市,安樂區,三民里,基隆市第01選區,林沛祥,中國國民黨,826,494,758,recall_disagree_votes,68,1252,2239,2289
10009030007,雲林縣,虎尾鎮,安慶里,雲林縣第01選區,丁學忠,中國國民黨,514,231,446,recall_disagree_votes,68,677,1221,1262
10004020013,新竹縣,竹東鎮,仁愛里,新竹縣第02選區,林思銘,中國國民黨,1138,377,1070,recall_disagree_votes,68,1447,3081,3120
65000220008,新北市,石門區,茂林里,新北市第01選區,洪孟楷,中國國民黨,215,104,147,recall_disagree_votes,68,251,482,530
10009160014,雲林縣,臺西鄉,蚊港村,雲林縣第01選區,丁學忠,中國國民黨,596,170,528,recall_disagree_votes,68,698,1525,1603
10015090001,花蓮縣,瑞穗鄉,瑞穗村,花蓮縣第01選區,傅崐萁,中國國民黨,555,309,488,recall_disagree_votes,67,797,1351,1425
63000080030,臺北市,文山區,樟林里,臺北市第08選區,賴士葆,中國國民黨,2468,1439,2401,recall_disagree_votes,67,3840,6727,6869
10004090002,新竹縣,北埔鄉,南興村,新竹縣第02選區,林思銘,中國國民黨,463,104,396,recall_disagree_votes,67,500,1090,1107
10008040022,南投縣,竹山鎮,鯉魚里,南投縣第02選區,游顥,中國國民黨,243,102,176,recall_disagree_votes,67,278,694,704
63000100025,臺北市,內湖區,內溝里,臺北市第04選區,李彥秀,中國國民黨,1303,967,1237,recall_disagree_votes,66,2204,3769,3814
66000040005,臺中市,西區,廣民里,臺中市第06選區,羅廷瑋,中國國民黨,457,320,391,recall_disagree_votes,66,711,1247,1319
66000040002,臺中市,西區,利民里,臺中市第06選區,羅廷瑋,中國國民黨,496,323,430,recall_disagree_votes,66,753,1303,1268
10004100005,新竹縣,寶山鄉,深井村,新竹縣第02選區,林思銘,中國國民黨,332,71,266,recall_disagree_votes,66,337,735,764
10015030002,花蓮縣,玉里鎮,啟模里,花蓮縣第01選區,傅崐萁,中國國民黨,456,214,391,recall_disagree_votes,65,605,1184,1230
66000050011,臺中市,北區,金龍里,臺中市第05選區,黃健豪,中國國民黨,1492,1080,1427,recall_disagree_votes,65,2507,4581,4238
66000290002,臺中市,和平區,天輪里,臺中市第08選區,江啟臣,中國國民黨,181,48,116,recall_disagree_votes,65,164,397,421
63000100016,臺北市,內湖區,紫雲里,臺北市第04選區,李彥秀,中國國民黨,1818,1000,1753,recall_disagree_votes,65,2753,4525,4643
68000040039,桃園市,楊梅區,裕新里,桃園市第02選區,涂權吉,中國國民黨,929,452,864,recall_disagree_votes,65,1316,2501,2382
10008120010,南投縣,信義鄉,神木村,南投縣第02選區,游顥,中國國民黨,242,37,177,recall_disagree_votes,65,214,538,579
65000210012,新北市,三芝區,店子里,新北市第01選區,洪孟楷,中國國民黨,190,128,125,recall_disagree_votes,65,253,513,537
65000210008,新北市,三芝區,錫板里,新北市第01選區,洪孟楷,中國國民黨,250,157,185,recall_disagree_votes,65,342,575,613
10015050004,花蓮縣,吉安鄉,永安村,花蓮縣第01選區,傅崐萁,中國國民黨,1380,977,1315,recall_disagree_votes,65,2292,3703,3782
66000190012,臺中市,新社區,中和里,臺中市第08選區,江啟臣,中國國民黨,312,38,248,recall_disagree_votes,64,286,534,528
10008070005,南投縣,鹿谷鄉,內湖村,南投縣第02選區,游顥,中國國民黨,376,109,312,recall_disagree_votes,64,421,907,938
65000040041,新北市,永和區,新生里,新北市第09選區,林德福,中國國民黨,382,126,318,recall_disagree_votes,64,444,786,841
63000090010,臺北市,南港區,合成里,臺北市第04選區,李彥秀,中國國民黨,1866,1405,1803,recall_disagree_votes,63,3208,5420,5417
10009030012,雲林縣,虎尾鎮,延平里,雲林縣第01選區,丁學忠,中國國民黨,477,206,414,recall_disagree_votes,63,620,1108,1105
10009030002,雲林縣,虎尾鎮,新興里,雲林縣第01選區,丁學忠,中國國民黨,580,313,517,recall_disagree_votes,63,830,1659,1644
65000010111,新北市,板橋區,華福里,新北市第07選區,葉元之,中國國民黨,599,456,536,recall_disagree_votes,63,992,1641,1649
65000100025,新北市,淡水區,清文里,新北市第01選區,洪孟楷,中國國民黨,356,278,293,recall_disagree_votes,63,571,1008,1017
65000030032,新北市,中和區,秀峰里,新北市第09選區,林德福,中國國民黨,1641,824,1578,recall_disagree_votes,63,2402,4284,4172
68000070030,桃園市,龜山區,新興里,桃園市第01選區,牛煦庭,中國國民黨,966,461,904,recall_disagree_votes,62,1365,3358,3089
10008120009,南投縣,信義鄉,同富村,南投縣第02選區,游顥,中國國民黨,465,130,403,recall_disagree_votes,62,533,1246,1291
10008030001,南投縣,草屯鎮,玉峰里,南投縣第01選區,馬文君,中國國民黨,746,379,684,recall_disagree_votes,62,1063,2093,1999
10008030002,南投縣,草屯鎮,炎峰里,南投縣第01選區,馬文君,中國國民黨,680,375,618,recall_disagree_votes,62,993,1922,1981
63000100001,臺北市,內湖區,西湖里,臺北市第04選區,李彥秀,中國國民黨,1951,1624,1889,recall_disagree_votes,62,3513,5736,5823
10008090009,南投縣,魚池鄉,五城村,南投縣第01選區,馬文君,中國國民黨,260,93,198,recall_disagree_votes,62,291,631,653
63000080009,臺北市,文山區,萬隆里,臺北市第08選區,賴士葆,中國國民黨,2147,1264,2086,recall_disagree_votes,61,3350,5558,5738
65000100007,新北市,淡水區,忠山里,新北市第01選區,洪孟楷,中國國民黨,302,178,241,recall_disagree_votes,61,419,743,757
65000110023,新北市,汐止區,東山里,新北市第12選區,廖先翔,中國國民黨,186,128,125,recall_disagree_votes,61,253,530,526
10008040021,南投縣,竹山鎮,福興里,南投縣第02選區,游顥,中國國民黨,235,71,175,recall_disagree_votes,60,246,551,566
68000010029,桃園市,桃園區,中成里,桃園市第04選區,萬美玲,中國國民黨,2498,1890,2438,recall_disagree_votes,60,4328,7766,6399
10008090007,南投縣,魚池鄉,共和村,南投縣第01選區,馬文君,中國國民黨,206,66,146,recall_disagree_votes,60,212,457,476
65000060024,新北市,新店區,雙坑里,新北市第11選區,羅明才,中國國民黨,218,109,158,recall_disagree_votes,60,267,661,686
10015090002,花蓮縣,瑞穗鄉,瑞美村,花蓮縣第01選區,傅崐萁,中國國民黨,568,316,508,recall_disagree_votes,60,824,1367,1382
65000180005,新北市,深坑區,阿柔里,新北市第11選區,羅明才,中國國民黨,196,80,136,recall_disagree_votes,60,216,509,535
10004020012,新竹縣,竹東鎮,鷄林里,新竹縣第02選區,林思銘,中國國民黨,1282,373,1222,recall_disagree_votes,60,1595,3335,3382
65000110002,新北市,汐止區,禮門里,新北市第12選區,廖先翔,中國國民黨,345,255,286,recall_disagree_votes,59,541,991,989
10008020012,南投縣,埔里鎮,麒麟里,南投縣第01選區,馬文君,中國國民黨,337,128,278,recall_disagree_votes,59,406,908,928
65000100026,新北市,淡水區,草東里,新北市第01選區,洪孟楷,中國國民黨,244,196,185,recall_disagree_votes,59,381,636,665
10017040005,基隆市,仁愛區,智仁里,基隆市第01選區,林沛祥,中國國民黨,672,468,613,recall_disagree_votes,59,1081,2067,2181
65000120029,新北市,瑞芳區,海濱里,新北市第12選區,廖先翔,中國國民黨,322,124,263,recall_disagree_votes,59,387,1039,1093
10004100004,新竹縣,寶山鄉,新城村,新竹縣第02選區,林思銘,中國國民黨,429,129,370,recall_disagree_votes,59,499,1089,1107
10008020021,南投縣,埔里鎮,向善里,南投縣第01選區,馬文君,中國國民黨,284,113,225,recall_disagree_votes,59,338,604,628
10017060017,基隆市,安樂區,五福里,基隆市第01選區,林沛祥,中國國民黨,1158,660,1099,recall_disagree_votes,59,1759,3116,3211
10009050012,雲林縣,土庫鎮,南平里,雲林縣第01選區,丁學忠,中國國民黨,534,393,475,recall_disagree_votes,59,868,1632,1663
10008030021,南投縣,草屯鎮,坪頂里,南投縣第01選區,馬文君,中國國民黨,380,146,322,recall_disagree_votes,58,468,932,967
10008090010,南投縣,魚池鄉,水社村,南投縣第01選區,馬文君,中國國民黨,329,80,271,recall_disagree_votes,58,351,741,759
63000100020,臺北市,內湖區,瑞陽里,臺北市第04選區,李彥秀,中國國民黨,2708,1438,2650,recall_disagree_votes,58,4088,6309,6358
10004020020,新竹縣,竹東鎮,中山里,新竹縣第02選區,林思銘,中國國民黨,618,149,560,recall_disagree_votes,58,709,1494,1537
66000100015,臺中市,東勢區,下城里,臺中市第08選區,江啟臣,中國國民黨,335,126,278,recall_disagree_votes,57,404,791,810
66000240009,臺中市,大肚區,永和里,臺中市第02選區,顏寬恒,中國國民黨,313,158,256,recall_disagree_votes,57,414,749,773
63000100037,臺北市,內湖區,蘆洲里,臺北市第04選區,李彥秀,中國國民黨,325,235,268,recall_disagree_votes,57,503,945,1004
66000190011,臺中市,新社區,慶西里,臺中市第08選區,江啟臣,中國國民黨,322,114,265,recall_disagree_votes,57,379,837,854
10004110004,新竹縣,峨眉鄉,富興村,新竹縣第02選區,林思銘,中國國民黨,485,136,429,recall_disagree_votes,56,565,1245,1296
10015050014,花蓮縣,吉安鄉,仁里村,花蓮縣第01選區,傅崐萁,中國國民黨,1800,1251,1744,recall_disagree_votes,56,2995,4828,4880
10008080003,南投縣,中寮鄉,八仙村,南投縣第01選區,馬文君,中國國民黨,270,122,214,recall_disagree_votes,56,336,712,724
65000110044,新北市,汐止區,長青里,新北市第12選區,廖先翔,中國國民黨,353,221,297,recall_disagree_votes,56,518,880,876
10008020002,南投縣,埔里鎮,南門里,南投縣第01選區,馬文君,中國國民黨,282,178,226,recall_disagree_votes,56,404,726,750
66000090006,臺中市,豐原區,富春里,臺中市第08選區,江啟臣,中國國民黨,287,144,231,recall_disagree_votes,56,375,624,660
68000020085,桃園市,中壢區,金華里,桃園市第03選區,魯明哲,中國國民黨,1689,843,1633,recall_disagree_votes,56,2476,4018,4002
10008100012,南投縣,國姓鄉,大石村,南投縣第01選區,馬文君,中國國民黨,266,69,210,recall_disagree_votes,56,279,626,650
66000040006,臺中市,西區,平和里,臺中市第06選區,羅廷瑋,中國國民黨,591,427,537,recall_disagree_votes,54,964,1795,1739
10009030001,雲林縣,虎尾鎮,中山里,雲林縣第01選區,丁學忠,中國國民黨,331,183,277,recall_disagree_votes,54,460,819,840
63000090015,臺北市,南港區,聯成里,臺北市第04選區,李彥秀,中國國民黨,1452,1000,1398,recall_disagree_votes,54,2398,3852,3911
68000020026,桃園市,中壢區,中原里,桃園市第03選區,魯明哲,中國國民黨,1245,751,1191,recall_disagree_votes,54,1942,3431,3452
10009050015,雲林縣,土庫鎮,後埔里,雲林縣第01選區,丁學忠,中國國民黨,763,447,710,recall_disagree_votes,53,1157,2222,2210
63000080041,臺北市,文山區,樟文里,臺北市第08選區,賴士葆,中國國民黨,1711,1208,1658,recall_disagree_votes,53,2866,4844,4971
10017060001,基隆市,安樂區,西川里,基隆市第01選區,林沛祥,中國國民黨,387,216,334,recall_disagree_votes,53,550,1107,1116
66000290005,臺中市,和平區,自由里,臺中市第08選區,江啟臣,中國國民黨,279,47,226,recall_disagree_votes,53,273,527,534
65000210007,新北市,三芝區,橫山里,新北市第01選區,洪孟楷,中國國民黨,209,80,157,recall_disagree_votes,52,237,430,464
10017060018,基隆市,安樂區,六合里,基隆市第01選區,林沛祥,中國國民黨,1435,767,1383,recall_disagree_votes,52,2150,3590,3694
10004020024,新竹縣,竹東鎮,忠孝里,新竹縣第02選區,林思銘,中國國民黨,506,141,454,recall_disagree_votes,52,595,1344,1355
10009160013,雲林縣,臺西鄉,和豐村,雲林縣第01選區,丁學忠,中國國民黨,840,393,788,recall_disagree_votes,52,1181,2664,2782
10004110005,新竹縣,峨眉鄉,七星村,新竹縣第02選區,林思銘,中國國民黨,229,55,177,recall_disagree_votes,52,232,567,585
10008130010,南投縣,仁愛鄉,南豐村,南投縣第01選區,馬文君,中國國民黨,215,50,163,recall_disagree_votes,52,213,490,507
63000100033,臺北市,內湖區,安泰里,臺北市第04選區,李彥秀,中國國民黨,1528,988,1476,recall_disagree_votes,52,2464,4218,4351
65000190002,新北市,石碇區,潭邊里,新北市第11選區,羅明才,中國國民黨,247,115,195,recall_disagree_votes,52,310,741,741
63000080012,臺北市,文山區,萬盛里,臺北市第08選區,賴士葆,中國國民黨,1402,909,1350,recall_disagree_votes,52,2259,3790,3918
10015060007,花蓮縣,壽豐鄉,壽豐村,花蓮縣第01選區,傅崐萁,中國國民黨,375,282,323,recall_disagree_votes,52,605,980,1001
66000090007,臺中市,豐原區,葫蘆里,臺中市第08選區,江啟臣,中國國民黨,212,133,160,recall_disagree_votes,52,293,543,575
65000040010,新北市,永和區,忠義里,新北市第09選區,林德福,中國國民黨,369,73,318,recall_disagree_votes,51,391,643,664
66000010008,臺中市,中區,中華里,臺中市第06選區,羅廷瑋,中國國民黨,597,466,546,recall_disagree_votes,51,1012,1898,1857
65000190006,新北市,石碇區,豐田里,新北市第11選區,羅明才,中國國民黨,130,68,79,recall_disagree_votes,51,147,367,352
10008020006,南投縣,埔里鎮,薰化里,南投縣第01選區,馬文君,中國國民黨,396,191,345,recall_disagree_votes,51,536,936,962
10008050008,南投縣,集集鎮,八張里,南投縣第02選區,游顥,中國國民黨,491,202,440,recall_disagree_votes,51,642,1326,1343
65000210011,新北市,三芝區,圓山里,新北市第01選區,洪孟楷,中國國民黨,204,78,153,recall_disagree_votes,51,231,466,498
68000070023,桃園市,龜山區,福源里,桃園市第01選區,牛煦庭,中國國民黨,662,397,611,recall_disagree_votes,51,1008,1731,1763
10017060012,基隆市,安樂區,中崙里,基隆市第01選區,林沛祥,中國國民黨,576,347,525,recall_disagree_votes,51,872,1652,1648
10015060011,花蓮縣,壽豐鄉,志學村,花蓮縣第01選區,傅崐萁,中國國民黨,705,632,655,recall_disagree_votes,50,1287,2144,2099
66000240002,臺中市,大肚區,中和里,臺中市第02選區,顏寬恒,中國國民黨,368,149,318,recall_disagree_votes,50,467,789,831
10009160012,雲林縣,臺西鄉,永豐村,雲林縣第01選區,丁學忠,中國國民黨,491,163,441,recall_disagree_votes,50,604,1201,1245
65000210010,新北市,三芝區,福德里,新北市第01選區,洪孟楷,中國國民黨,297,166,247,recall_disagree_votes,50,413,733,728
10015030005,花蓮縣,玉里鎮,國武里,花蓮縣第01選區,傅崐萁,中國國民黨,370,219,320,recall_disagree_votes,50,539,949,992
10015020010,花蓮縣,鳳林鎮,林榮里,花蓮縣第01選區,傅崐萁,中國國民黨,305,142,255,recall_disagree_votes,50,397,656,691
63000050008,臺北市,中正區,板溪里,臺北市第08選區,賴士葆,中國國民黨,1000,633,950,recall_disagree_votes,50,1583,2799,2849
68000010025,桃園市,桃園區,西湖里,桃園市第04選區,萬美玲,中國國民黨,490,361,440,recall_disagree_votes,50,801,1353,1358
63000100015,臺北市,內湖區,碧山里,臺北市第04選區,李彥秀,中國國民黨,2085,1506,2035,recall_disagree_votes,50,3541,5774,5827
68000020060,桃園市,中壢區,普忠里,桃園市第03選區,魯明哲,中國國民黨,1054,651,1004,recall_disagree_votes,50,1655,3119,3140
63000100011,臺北市,內湖區,紫星里,臺北市第04選區,李彥秀,中國國民黨,2229,1796,2179,recall_disagree_votes,50,3975,6364,6547
10008100013,南投縣,國姓鄉,長豐村,南投縣第01選區,馬文君,中國國民黨,279,61,230,recall_disagree_votes,49,291,691,712
68000040020,桃園市,楊梅區,富岡里,桃園市第02選區,涂權吉,中國國民黨,740,327,691,recall_disagree_votes,49,1018,1749,1702
10009160002,雲林縣,臺西鄉,海北村,雲林縣第01選區,丁學忠,中國國民黨,339,138,290,recall_disagree_votes,49,428,975,1023
10008040024,南投縣,竹山鎮,坪頂里,南投縣第02選區,游顥,中國國民黨,173,51,124,recall_disagree_votes,49,175,404,436
10008050009,南投縣,集集鎮,永昌里,南投縣第02選區,游顥,中國國民黨,324,174,275,recall_disagree_votes,49,449,868,901
65000210006,新北市,三芝區,茂長里,新北市第01選區,洪孟楷,中國國民黨,259,143,210,recall_disagree_votes,49,353,573,591
10008060023,南投縣,名間鄉,仁和村,南投縣第02選區,游顥,中國國民黨,305,142,257,recall_disagree_votes,48,399,817,818
65000100001,新北市,淡水區,中和里,新北市第01選區,洪孟楷,中國國民黨,211,140,163,recall_disagree_votes,48,303,518,530
10008050011,南投縣,集集鎮,廣明里,南投縣第02選區,游顥,中國國民黨,314,108,266,recall_disagree_votes,48,374,788,828
66000290008,臺中市,和平區,平等里,臺中市第08選區,江啟臣,中國國民黨,136,16,88,recall_disagree_votes,48,104,348,366
10008020014,南投縣,埔里鎮,溪南里,南投縣第01選區,馬文君,中國國民黨,433,148,385,recall_disagree_votes,48,533,1009,1003
10009200018,雲林縣,水林鄉,松北村,雲林縣第01選區,丁學忠,中國國民黨,277,202,229,recall_disagree_votes,48,431,889,920
10004080008,新竹縣,橫山鄉,沙坑村,新竹縣第02選區,林思銘,中國國民黨,340,116,293,recall_disagree_votes,47,409,854,885
10004110001,新竹縣,峨眉鄉,峨眉村,新竹縣第02選區,林思銘,中國國民黨,334,84,287,recall_disagree_votes,47,371,739,761
10009050006,雲林縣,土庫鎮,興新里,雲林縣第01選區,丁學忠,中國國民黨,428,307,381,recall_disagree_votes,47,688,1337,1357
10008030010,南投縣,草屯鎮,碧洲里,南投縣第01選區,馬文君,中國國民黨,942,424,895,recall_disagree_votes,47,1319,2430,2433
63000050006,臺北市,中正區,頂東里,臺北市第08選區,賴士葆,中國國民黨,1624,1230,1577,recall_disagree_votes,47,2807,4778,4954
10004020017,新竹縣,竹東鎮,員山里,新竹縣第02選區,林思銘,中國國民黨,703,245,657,recall_disagree_votes,46,902,1873,1839
65000190001,新北市,石碇區,石碇里,新北市第11選區,羅明才,中國國民黨,151,74,105,recall_disagree_votes,46,179,342,357
10008080014,南投縣,中寮鄉,龍岩村,南投縣第01選區,馬文君,中國國民黨,258,72,212,recall_disagree_votes,46,284,571,602
10008040023,南投縣,竹山鎮,瑞竹里,南投縣第02選區,游顥,中國國民黨,184,82,138,recall_disagree_votes,46,220,518,542
10008020031,南投縣,埔里鎮,杷城里,南投縣第01選區,馬文君,中國國民黨,948,302,902,recall_disagree_votes,46,1204,2304,2396
68000010001,桃園市,桃園區,文化里,桃園市第04選區,萬美玲,中國國民黨,393,285,347,recall_disagree_votes,46,632,1080,1046
10017060020,基隆市,安樂區,鶯歌里,基隆市第01選區,林沛祥,中國國民黨,841,478,795,recall_disagree_votes,46,1273,2595,2597
10017060006,基隆市,安樂區,干城里,基隆市第01選區,林沛祥,中國國民黨,582,363,537,recall_disagree_votes,45,900,1792,1887
63000100027,臺北市,內湖區,行善里,臺北市第04選區,李彥秀,中國國民黨,2008,1601,1964,recall_disagree_votes,44,3565,5852,5924
10015110009,花蓮縣,秀林鄉,和平村,花蓮縣第01選區,傅崐萁,中國國民黨,182,127,138,recall_disagree_votes,44,265,493,499
10008020024,南投縣,埔里鎮,史港里,南投縣第01選區,馬文君,中國國民黨,241,77,197,recall_disagree_votes,44,274,514,528
10008100006,南投縣,國姓鄉,長福村,南投縣第01選區,馬文君,中國國民黨,267,72,223,recall_disagree_votes,44,295,638,667
66000260016,臺中市,霧峰區,峰谷里,臺中市第02選區,顏寬恒,中國國民黨,426,181,382,recall_disagree_votes,44,563,1076,1075
63000080033,臺北市,文山區,萬芳里,臺北市第08選區,賴士葆,中國國民黨,2341,1418,2298,recall_disagree_votes,43,3716,6313,6394
10017050009,基隆市,中山區,通化里,基隆市第01選區,林沛祥,中國國民黨,326,154,283,recall_disagree_votes,43,437,885,924
10008080001,南投縣,中寮鄉,廣興村,南投縣第01選區,馬文君,中國國民黨,242,120,199,recall_disagree_votes,43,319,691,739
10008120004,南投縣,信義鄉,明德村,南投縣第02選區,游顥,中國國民黨,351,125,308,recall_disagree_votes,43,433,905,961
10008040025,南投縣,竹山鎮,桶頭里,南投縣第02選區,游顥,中國國民黨,259,88,217,recall_disagree_votes,42,305,790,808
10004100006,新竹縣,寶山鄉,寶斗村,新竹縣第02選區,林思銘,中國國民黨,252,53,210,recall_disagree_votes,42,263,667,696
10008040010,南投縣,竹山鎮,德興里,南投縣第02選區,游顥,中國國民黨,319,109,277,recall_disagree_votes,42,386,814,844
10009180013,雲林縣,四湖鄉,崙北村,雲林縣第01選區,丁學忠,中國國民黨,395,263,353,recall_disagree_votes,42,616,1503,1564
63000030039,臺北市,大安區,臥龍里,臺北市第06選區,羅智強,中國國民黨,642,370,601,recall_disagree_votes,41,971,1620,1604
10008090013,南投縣,魚池鄉,日月村,南投縣第01選區,馬文君,中國國民黨,238,80,197,recall_disagree_votes,41,277,544,559
10009140002,雲林縣,東勢鄉,東北村,雲林縣第01選區,丁學忠,中國國民黨,395,205,354,recall_disagree_votes,41,559,1134,1132
10017060008,基隆市,安樂區,嘉仁里,基隆市第01選區,林沛祥,中國國民黨,872,706,831,recall_disagree_votes,41,1537,2889,2984
10015040001,花蓮縣,新城鄉,新城村,花蓮縣第01選區,傅崐萁,中國國民黨,378,263,337,recall_disagree_votes,41,600,975,992
63000050003,臺北市,中正區,文盛里,臺北市第08選區,賴士葆,中國國民黨,690,529,649,recall_disagree_votes,41,1178,2058,2164
10015100009,花蓮縣,富里鄉,富里村,花蓮縣第01選區,傅崐萁,中國國民黨,439,188,398,recall_disagree_votes,41,586,1151,1176
10004080006,新竹縣,橫山鄉,內灣村,新竹縣第02選區,林思銘,中國國民黨,322,83,281,recall_disagree_votes,41,364,801,824
68000020001,桃園市,中壢區,龍平里,桃園市第03選區,魯明哲,中國國民黨,1261,336,1221,recall_disagree_votes,40,1557,2671,2709
68000010014,桃園市,桃園區,東山里,桃園市第04選區,萬美玲,中國國民黨,656,501,616,recall_disagree_votes,40,1117,2037,1859
10014100004,臺東縣,大武鄉,尚武村,臺東縣第01選區,黃建賓,中國國民黨,266,165,226,recall_disagree_votes,40,391,915,957
68000050009,桃園市,蘆竹區,五福里,桃園市第01選區,牛煦庭,中國國民黨,803,568,763,recall_disagree_votes,40,1331,2258,2289
63000080039,臺北市,文山區,萬美里,臺北市第08選區,賴士葆,中國國民黨,2075,1282,2035,recall_disagree_votes,40,3317,5756,5918
68000040032,桃園市,楊梅區,新榮里,桃園市第02選區,涂權吉,中國國民黨,1143,790,1103,recall_disagree_votes,40,1893,3288,3280
10008110007,南投縣,水里鄉,鉅工村,南投縣第02選區,游顥,中國國民黨,282,115,242,recall_disagree_votes,40,357,775,835
68000040008,桃園市,楊梅區,上田里,桃園市第02選區,涂權吉,中國國民黨,1019,602,979,recall_disagree_votes,40,1581,2934,2819
65000250002,新北市,雙溪區,共和里,新北市第12選區,廖先翔,中國國民黨,114,54,74,recall_disagree_votes,40,128,301,328
10008020015,南投縣,埔里鎮,桃米里,南投縣第01選區,馬文君,中國國民黨,363,120,324,recall_disagree_votes,39,444,943,947
10015020002,花蓮縣,鳳林鎮,鳳義里,花蓮縣第01選區,傅崐萁,中國國民黨,253,106,214,recall_disagree_votes,39,320,543,555
63000050001,臺北市,中正區,水源里,臺北市第08選區,賴士葆,中國國民黨,726,571,687,recall_disagree_votes,39,1258,2394,2428
10015070007,花蓮縣,光復鄉,大全村,花蓮縣第01選區,傅崐萁,中國國民黨,144,113,105,recall_disagree_votes,39,218,419,479
10004020011,新竹縣,竹東鎮,榮樂里,新竹縣第02選區,林思銘,中國國民黨,490,145,452,recall_disagree_votes,38,597,1198,1253
68000030023,桃園市,大溪區,光明里,桃園市第06選區,邱若華,中國國民黨,786,377,748,recall_disagree_votes,38,1125,2228,2205
10015030004,花蓮縣,玉里鎮,泰昌里,花蓮縣第01選區,傅崐萁,中國國民黨,298,134,260,recall_disagree_votes,38,394,960,1050
10009190001,雲林縣,口湖鄉,湖東村,雲林縣第01選區,丁學忠,中國國民黨,371,180,333,recall_disagree_votes,38,513,1090,1109
65000120004,新北市,瑞芳區,龍川里,新北市第12選區,廖先翔,中國國民黨,490,275,452,recall_disagree_votes,38,727,1463,1480
10008110006,南投縣,水里鄉,北埔村,南投縣第02選區,游顥,中國國民黨,340,140,302,recall_disagree_votes,38,442,966,972
10004090001,新竹縣,北埔鄉,北埔村,新竹縣第02選區,林思銘,中國國民黨,389,117,351,recall_disagree_votes,38,468,1019,1053
63000100008,臺北市,內湖區,港華里,臺北市第04選區,李彥秀,中國國民黨,2441,1894,2403,recall_disagree_votes,38,4297,7101,7250
10015090009,花蓮縣,瑞穗鄉,富源村,花蓮縣第01選區,傅崐萁,中國國民黨,182,87,145,recall_disagree_votes,37,232,420,441
10009190017,雲林縣,口湖鄉,水井村,雲林縣第01選區,丁學忠,中國國民黨,327,169,290,recall_disagree_votes,37,459,860,871
68000020065,桃園市,中壢區,龍德里,桃園市第03選區,魯明哲,中國國民黨,1558,779,1521,recall_disagree_votes,37,2300,3871,3925
65000030063,新北市,中和區,瑞穗里,新北市第08選區,張智倫,中國國民黨,687,462,650,recall_disagree_votes,37,1112,1998,2003
10009030015,雲林縣,虎尾鎮,墾地里,雲林縣第01選區,丁學忠,中國國民黨,892,520,855,recall_disagree_votes,37,1375,2765,2180
63000090020,臺北市,南港區,重陽里,臺北市第04選區,李彥秀,中國國民黨,1811,1200,1774,recall_disagree_votes,37,2974,5040,4851
68000020059,桃園市,中壢區,和平里,桃園市第03選區,魯明哲,中國國民黨,882,546,846,recall_disagree_votes,36,1392,2377,2425
10009190002,雲林縣,口湖鄉,口湖村,雲林縣第01選區,丁學忠,中國國民黨,323,198,287,recall_disagree_votes,36,485,1011,1031
10008070008,南投縣,鹿谷鄉,和雅村,南投縣第02選區,游顥,中國國民黨,259,67,223,recall_disagree_votes,36,290,580,597
10008080016,南投縣,中寮鄉,內城村,南投縣第01選區,馬文君,中國國民黨,164,62,128,recall_disagree_votes,36,190,440,423
65000240009,新北市,平溪區,南山里,新北市第12選區,廖先翔,中國國民黨,108,48,72,recall_disagree_votes,36,120,298,311
10008030024,南投縣,草屯鎮,中正里,南投縣第01選區,馬文君,中國國民黨,223,110,187,recall_disagree_votes,36,297,577,620
10008080004,南投縣,中寮鄉,和興村,南投縣第01選區,馬文君,中國國民黨,215,71,179,recall_disagree_votes,36,250,553,593
10004110003,新竹縣,峨眉鄉,石井村,新竹縣第02選區,林思銘,中國國民黨,215,72,180,recall_disagree_votes,35,252,502,529
10017070002,基隆市,信義區,仁義里,基隆市第01選區,林沛祥,中國國民黨,430,246,395,recall_disagree_votes,35,641,1070,1130
63000050005,臺北市,中正區,河堤里,臺北市第08選區,賴士葆,中國國民黨,1238,891,1203,recall_disagree_votes,35,2094,3642,3691
10017010014,基隆市,中正區,中濱里,基隆市第01選區,林沛祥,中國國民黨,376,215,341,recall_disagree_votes,35,556,1084,1099
65000100030,新北市,淡水區,新生里,新北市第01選區,洪孟楷,中國國民黨,154,109,119,recall_disagree_votes,35,228,388,384
10008110005,南投縣,水里鄉,城中村,南投縣第02選區,游顥,中國國民黨,310,112,275,recall_disagree_votes,35,387,774,811
10008090012,南投縣,魚池鄉,武登村,南投縣第01選區,馬文君,中國國民黨,197,49,163,recall_disagree_votes,34,212,497,522
10015090004,花蓮縣,瑞穗鄉,瑞祥村,花蓮縣第01選區,傅崐萁,中國國民黨,235,152,201,recall_disagree_votes,34,353,626,644
63000100036,臺北市,內湖區,明湖里,臺北市第04選區,李彥秀,中國國民黨,1400,1043,1366,recall_disagree_votes,34,2409,4055,4191
10015020011,花蓮縣,鳳林鎮,長橋里,花蓮縣第01選區,傅崐萁,中國國民黨,284,145,250,recall_disagree_votes,34,395,681,712
68000040006,桃園市,楊梅區,東流里,桃園市第02選區,涂權吉,中國國民黨,953,635,919,recall_disagree_votes,34,1554,2867,2838
10015060010,花蓮縣,壽豐鄉,平和村,花蓮縣第01選區,傅崐萁,中國國民黨,329,330,295,recall_disagree_votes,34,625,1048,1051
10008120008,南投縣,信義鄉,望美村,南投縣第02選區,游顥,中國國民黨,109,25,76,recall_disagree_votes,33,101,289,306
68000020008,桃園市,中壢區,自立里,桃園市第03選區,魯明哲,中國國民黨,2338,499,2305,recall_disagree_votes,33,2804,4869,4853
10008110014,南投縣,水里鄉,上安村,南投縣第02選區,游顥,中國國民黨,343,137,310,recall_disagree_votes,33,447,975,1018
65000120005,新北市,瑞芳區,龍山里,新北市第12選區,廖先翔,中國國民黨,403,202,370,recall_disagree_votes,33,572,1187,1197
10015070001,花蓮縣,光復鄉,大安村,花蓮縣第01選區,傅崐萁,中國國民黨,252,203,219,recall_disagree_votes,33,422,675,685
10008050004,南投縣,集集鎮,田寮里,南投縣第02選區,游顥,中國國民黨,356,196,323,recall_disagree_votes,33,519,1011,1043
65000190009,新北市,石碇區,光明里,新北市第11選區,羅明才,中國國民黨,91,43,58,recall_disagree_votes,33,101,256,250
68000020077,桃園市,中壢區,莊敬里,桃園市第03選區,魯明哲,中國國民黨,1519,422,1486,recall_disagree_votes,33,1908,3249,3223
68000100018,桃園市,平鎮區,東社里,桃園市第05選區,呂玉玲,中國國民黨,1139,506,1107,recall_disagree_votes,32,1613,2985,3037
10004090007,新竹縣,北埔鄉,大湖村,新竹縣第02選區,林思銘,中國國民黨,223,40,191,recall_disagree_votes,32,231,483,508
10009050001,雲林縣,土庫鎮,忠正里,雲林縣第01選區,丁學忠,中國國民黨,247,179,215,recall_disagree_votes,32,394,699,737
66000100024,臺中市,東勢區,埤頭里,臺中市第08選區,江啟臣,中國國民黨,245,114,213,recall_disagree_votes,32,327,610,634
10008080015,南投縣,中寮鄉,永和村,南投縣第01選區,馬文君,中國國民黨,196,58,164,recall_disagree_votes,32,222,465,484
68000130008,桃園市,復興區,華陵里,桃園市第06選區,邱若華,中國國民黨,109,43,78,recall_disagree_votes,31,121,402,419
10015030008,花蓮縣,玉里鎮,樂合里,花蓮縣第01選區,傅崐萁,中國國民黨,111,45,80,recall_disagree_votes,31,125,285,291
10008040002,南投縣,竹山鎮,中正里,南投縣第02選區,游顥,中國國民黨,210,106,179,recall_disagree_votes,31,285,545,570
10004130004,新竹縣,五峰鄉,桃山村,新竹縣第02選區,林思銘,中國國民黨,52,22,21,recall_disagree_votes,31,43,165,166
68000020072,桃園市,中壢區,仁福里,桃園市第03選區,魯明哲,中國國民黨,1680,797,1649,recall_disagree_votes,31,2446,4537,4503
10015050009,花蓮縣,吉安鄉,干城村,花蓮縣第01選區,傅崐萁,中國國民黨,339,160,308,recall_disagree_votes,31,468,904,888
65000220007,新北市,石門區,乾華里,新北市第01選區,洪孟楷,中國國民黨,100,34,69,recall_disagree_votes,31,103,245,269
66000240012,臺中市,大肚區,成功里,臺中市第02選區,顏寬恒,中國國民黨,453,127,422,recall_disagree_votes,31,549,871,904
10015050018,花蓮縣,吉安鄉,光華村,花蓮縣第01選區,傅崐萁,中國國民黨,588,326,557,recall_disagree_votes,31,883,1523,1476
68000050037,桃園市,蘆竹區,上興里,桃園市第01選區,牛煦庭,中國國民黨,1180,921,1150,recall_disagree_votes,30,2071,3526,3437
10015100010,花蓮縣,富里鄉,永豐村,花蓮縣第01選區,傅崐萁,中國國民黨,154,52,124,recall_disagree_votes,30,176,385,399
65000030092,新北市,中和區,正南里,新北市第08選區,張智倫,中國國民黨,1067,487,1037,recall_disagree_votes,30,1524,2925,2976
10015020003,花蓮縣,鳳林鎮,鳳禮里,花蓮縣第01選區,傅崐萁,中國國民黨,222,144,192,recall_disagree_votes,30,336,496,500
68000020058,桃園市,中壢區,福德里,桃園市第03選區,魯明哲,中國國民黨,1034,557,1004,recall_disagree_votes,30,1561,2697,2685
10015050013,花蓮縣,吉安鄉,宜昌村,花蓮縣第01選區,傅崐萁,中國國民黨,1081,885,1051,recall_disagree_votes,30,1936,3023,3005
66000100014,臺中市,東勢區,上城里,臺中市第08選區,江啟臣,中國國民黨,407,145,377,recall_disagree_votes,30,522,921,912
10008090008,南投縣,魚池鄉,大雁村,南投縣第01選區,馬文君,中國國民黨,195,66,165,recall_disagree_votes,30,231,568,595
65000240007,新北市,平溪區,東勢里,新北市第12選區,廖先翔,中國國民黨,132,90,103,recall_disagree_votes,29,193,386,401
10009030017,雲林縣,虎尾鎮,芳草里,雲林縣第01選區,丁學忠,中國國民黨,245,205,216,recall_disagree_votes,29,421,861,872
10017040007,基隆市,仁愛區,忠勇里,基隆市第01選區,林沛祥,中國國民黨,250,211,221,recall_disagree_votes,29,432,876,875
10004100003,新竹縣,寶山鄉,三峰村,新竹縣第02選區,林思銘,中國國民黨,367,114,338,recall_disagree_votes,29,452,964,995
68000020005,桃園市,中壢區,內壢里,桃園市第03選區,魯明哲,中國國民黨,799,394,770,recall_disagree_votes,29,1164,2045,2091
10015070005,花蓮縣,光復鄉,大同村,花蓮縣第01選區,傅崐萁,中國國民黨,188,148,159,recall_disagree_votes,29,307,567,590
10015030006,花蓮縣,玉里鎮,源城里,花蓮縣第01選區,傅崐萁,中國國民黨,349,159,320,recall_disagree_votes,29,479,893,931
10015060002,花蓮縣,壽豐鄉,溪口村,花蓮縣第01選區,傅崐萁,中國國民黨,201,135,172,recall_disagree_votes,29,307,557,599
10009030027,雲林縣,虎尾鎮,建國里,雲林縣第01選區,丁學忠,中國國民黨,207,63,179,recall_disagree_votes,28,242,518,519
68000040037,桃園市,楊梅區,高上里,桃園市第02選區,涂權吉,中國國民黨,988,570,960,recall_disagree_votes,28,1530,2645,2618
10008080005,南投縣,中寮鄉,福盛村,南投縣第01選區,馬文君,中國國民黨,234,92,206,recall_disagree_votes,28,298,605,630
10008080012,南投縣,中寮鄉,清水村,南投縣第01選區,馬文君,中國國民黨,292,110,264,recall_disagree_votes,28,374,792,825
10004100007,新竹縣,寶山鄉,山湖村,新竹縣第02選區,林思銘,中國國民黨,217,74,189,recall_disagree_votes,28,263,511,524
10015100006,花蓮縣,富里鄉,羅山村,花蓮縣第01選區,傅崐萁,中國國民黨,167,53,140,recall_disagree_votes,27,193,387,396
10008050001,南投縣,集集鎮,集集里,南投縣第02選區,游顥,中國國民黨,408,152,381,recall_disagree_votes,27,533,982,994
63000080014,臺北市,文山區,興光里,臺北市第08選區,賴士葆,中國國民黨,1099,782,1072,recall_disagree_votes,27,1854,3249,3265
68000040002,桃園市,楊梅區,楊江里,桃園市第02選區,涂權吉,中國國民黨,463,197,436,recall_disagree_votes,27,633,1033,1034
63000080021,臺北市,文山區,興泰里,臺北市第08選區,賴士葆,中國國民黨,1220,770,1193,recall_disagree_votes,27,1963,3357,3429
10004020008,新竹縣,竹東鎮,東華里,新竹縣第02選區,林思銘,中國國民黨,250,71,223,recall_disagree_votes,27,294,590,606
10015100005,花蓮縣,富里鄉,竹田村,花蓮縣第01選區,傅崐萁,中國國民黨,398,111,371,recall_disagree_votes,27,482,911,926
10008110001,南投縣,水里鄉,水里村,南投縣第02選區,游顥,中國國民黨,229,86,202,recall_disagree_votes,27,288,632,652
10004020002,新竹縣,竹東鎮,瑞峰里,新竹縣第02選區,林思銘,中國國民黨,154,52,127,recall_disagree_votes,27,179,364,374
10017010015,基隆市,中正區,海濱里,基隆市第01選區,林沛祥,中國國民黨,220,151,193,recall_disagree_votes,27,344,708,727
66000130004,臺中市,沙鹿區,美仁里,臺中市第02選區,顏寬恒,中國國民黨,196,90,170,recall_disagree_votes,26,260,481,450
10015030015,花蓮縣,玉里鎮,大禹里,花蓮縣第01選區,傅崐萁,中國國民黨,268,110,242,recall_disagree_votes,26,352,704,730
10009050002,雲林縣,土庫鎮,順天里,雲林縣第01選區,丁學忠,中國國民黨,281,201,255,recall_disagree_votes,26,456,799,821
10008050002,南投縣,集集鎮,和平里,南投縣第02選區,游顥,中國國民黨,318,121,292,recall_disagree_votes,26,413,846,850
68000050036,桃園市,蘆竹區,中興里,桃園市第01選區,牛煦庭,中國國民黨,1681,1318,1655,recall_disagree_votes,26,2973,5287,5102
10017040006,基隆市,仁愛區,和明里,基隆市第01選區,林沛祥,中國國民黨,541,338,515,recall_disagree_votes,26,853,1583,1656
10009060010,雲林縣,北港鎮,賜福里,雲林縣第01選區,丁學忠,中國國民黨,108,83,82,recall_disagree_votes,26,165,283,284
68000020014,桃園市,中壢區,新街里,桃園市第03選區,魯明哲,中國國民黨,799,518,773,recall_disagree_votes,26,1291,2385,2304
63000050002,臺北市,中正區,富水里,臺北市第08選區,賴士葆,中國國民黨,678,306,653,recall_disagree_votes,25,959,1848,1919
10009130010,雲林縣,麥寮鄉,新吉村,雲林縣第01選區,丁學忠,中國國民黨,367,174,342,recall_disagree_votes,25,516,1167,1188
63000080026,臺北市,文山區,明興里,臺北市第08選區,賴士葆,中國國民黨,2035,1205,2010,recall_disagree_votes,25,3215,5447,5588
10009190013,雲林縣,口湖鄉,港西村,雲林縣第01選區,丁學忠,中國國民黨,217,146,192,recall_disagree_votes,25,338,766,794
10015110002,花蓮縣,秀林鄉,富世村,花蓮縣第01選區,傅崐萁,中國國民黨,115,61,90,recall_disagree_votes,25,151,297,316
10008080018,南投縣,中寮鄉,爽文村,南投縣第01選區,馬文君,中國國民黨,165,67,140,recall_disagree_votes,25,207,404,439
68000130002,桃園市,復興區,澤仁里,桃園市第06選區,邱若華,中國國民黨,193,124,169,recall_disagree_votes,24,293,611,633
10015100002,花蓮縣,富里鄉,東里村,花蓮縣第01選區,傅崐萁,中國國民黨,241,132,217,recall_disagree_votes,24,349,769,799
10004020003,新竹縣,竹東鎮,軟橋里,新竹縣第02選區,林思銘,中國國民黨,136,49,112,recall_disagree_votes,24,161,346,342
10004100001,新竹縣,寶山鄉,雙溪村,新竹縣第02選區,林思銘,中國國民黨,823,311,799,recall_disagree_votes,24,1110,2605,2578
10015040004,花蓮縣,新城鄉,北埔村,花蓮縣第01選區,傅崐萁,中國國民黨,839,532,815,recall_disagree_votes,24,1347,2340,2341
65000190010,新北市,石碇區,豐林里,新北市第11選區,羅明才,中國國民黨,100,55,76,recall_disagree_votes,24,131,273,281
10008030020,南投縣,草屯鎮,土城里,南投縣第01選區,馬文君,中國國民黨,544,221,520,recall_disagree_votes,24,741,1543,1560
10008030015,南投縣,草屯鎮,石川里,南投縣第01選區,馬文君,中國國民黨,502,265,478,recall_disagree_votes,24,743,1536,1504
10009180005,雲林縣,四湖鄉,湖西村,雲林縣第01選區,丁學忠,中國國民黨,758,413,735,recall_disagree_votes,23,1148,2075,2098
10017050011,基隆市,中山區,通明里,基隆市第01選區,林沛祥,中國國民黨,467,348,444,recall_disagree_votes,23,792,1519,1584
68000020076,桃園市,中壢區,華愛里,桃園市第03選區,魯明哲,中國國民黨,1343,580,1320,recall_disagree_votes,23,1900,3363,3304
10015100012,花蓮縣,富里鄉,富南村,花蓮縣第01選區,傅崐萁,中國國民黨,138,49,115,recall_disagree_votes,23,164,371,385
10015020005,花蓮縣,鳳林鎮,鳳信里,花蓮縣第01選區,傅崐萁,中國國民黨,297,138,274,recall_disagree_votes,23,412,688,707
68000040012,桃園市,楊梅區,金龍里,桃園市第02選區,涂權吉,中國國民黨,774,287,751,recall_disagree_votes,23,1038,1850,1626
10004090009,新竹縣,北埔鄉,外坪村,新竹縣第02選區,林思銘,中國國民黨,98,43,75,recall_disagree_votes,23,118,265,270
10004020010,新竹縣,竹東鎮,竹東里,新竹縣第02選區,林思銘,中國國民黨,445,194,422,recall_disagree_votes,23,616,1186,1230
65000030069,新北市,中和區,國光里,新北市第08選區,張智倫,中國國民黨,1070,846,1048,recall_disagree_votes,22,1894,3289,3324
68000040035,桃園市,楊梅區,永平里,桃園市第02選區,涂權吉,中國國民黨,786,395,764,recall_disagree_votes,22,1159,2155,1938
10009060013,雲林縣,北港鎮,仁安里,雲林縣第01選區,丁學忠,中國國民黨,159,105,137,recall_disagree_votes,22,242,413,401
10004020025,新竹縣,竹東鎮,陸豐里,新竹縣第02選區,林思銘,中國國民黨,243,62,221,recall_disagree_votes,22,283,528,543
10008040019,南投縣,竹山鎮,大鞍里,南投縣第02選區,游顥,中國國民黨,129,42,107,recall_disagree_votes,22,149,380,380
65000190005,新北市,石碇區,彭山里,新北市第11選區,羅明才,中國國民黨,106,46,84,recall_disagree_votes,22,130,289,280
10004080011,新竹縣,橫山鄉,力行村,新竹縣第02選區,林思銘,中國國民黨,333,69,311,recall_disagree_votes,22,380,715,751
10008060020,南投縣,名間鄉,崁腳村,南投縣第02選區,游顥,中國國民黨,295,136,273,recall_disagree_votes,22,409,796,811
10008060021,南投縣,名間鄉,新厝村,南投縣第02選區,游顥,中國國民黨,239,131,217,recall_disagree_votes,22,348,671,688
65000120017,新北市,瑞芳區,碩仁里,新北市第12選區,廖先翔,中國國民黨,57,32,35,recall_disagree_votes,22,67,140,143
10009050005,雲林縣,土庫鎮,溪邊里,雲林縣第01選區,丁學忠,中國國民黨,353,239,332,recall_disagree_votes,21,571,1064,1045
10004130001,新竹縣,五峰鄉,大隘村,新竹縣第02選區,林思銘,中國國民黨,45,5,24,recall_disagree_votes,21,29,81,99
10017050017,基隆市,中山區,西華里,基隆市第01選區,林沛祥,中國國民黨,232,196,211,recall_disagree_votes,21,407,740,752
10004080005,新竹縣,橫山鄉,豐田村,新竹縣第02選區,林思銘,中國國民黨,116,44,95,recall_disagree_votes,21,139,297,317
10009060028,雲林縣,北港鎮,新厝里,雲林縣第01選區,丁學忠,中國國民黨,115,70,94,recall_disagree_votes,21,164,364,368
10009180018,雲林縣,四湖鄉,林東村,雲林縣第01選區,丁學忠,中國國民黨,239,121,218,recall_disagree_votes,21,339,858,882
10004080007,新竹縣,橫山鄉,福興村,新竹縣第02選區,林思銘,中國國民黨,144,39,123,recall_disagree_votes,21,162,370,391
68000040022,桃園市,楊梅區,員本里,桃園市第02選區,涂權吉,中國國民黨,1066,642,1045,recall_disagree_votes,21,1687,2938,2835
10008050003,南投縣,集集鎮,林尾里,南投縣第02選區,游顥,中國國民黨,185,84,164,recall_disagree_votes,21,248,497,527
63000080038,臺北市,文山區,忠順里,臺北市第08選區,賴士葆,中國國民黨,1428,713,1407,recall_disagree_votes,21,2120,3470,3519
63000080027,臺北市,文山區,木柵里,臺北市第08選區,賴士葆,中國國民黨,3125,1616,3105,recall_disagree_votes,20,4721,7904,7849
10008080002,南投縣,中寮鄉,崁頂村,南投縣第01選區,馬文君,中國國民黨,160,51,140,recall_disagree_votes,20,191,436,448
10015100013,花蓮縣,富里鄉,學田村,花蓮縣第01選區,傅崐萁,中國國民黨,182,123,162,recall_disagree_votes,20,285,476,489
66000080019,臺中市,北屯區,四民里,臺中市第05選區,黃健豪,中國國民黨,778,571,758,recall_disagree_votes,20,1329,2353,2141
10017050022,基隆市,中山區,德安里,基隆市第01選區,林沛祥,中國國民黨,1115,812,1095,recall_disagree_votes,20,1907,3598,3666
10015050017,花蓮縣,吉安鄉,仁和村,花蓮縣第01選區,傅崐萁,中國國民黨,1195,826,1175,recall_disagree_votes,20,2001,3350,3367
68000030019,桃園市,大溪區,仁武里,桃園市第06選區,邱若華,中國國民黨,937,600,917,recall_disagree_votes,20,1517,2906,2953
10004080002,新竹縣,橫山鄉,田寮村,新竹縣第02選區,林思銘,中國國民黨,325,108,305,recall_disagree_votes,20,413,812,818
10017060003,基隆市,安樂區,新西里,基隆市第01選區,林沛祥,中國國民黨,369,232,349,recall_disagree_votes,20,581,1203,1234
10008120005,南投縣,信義鄉,愛國村,南投縣第02選區,游顥,中國國民黨,178,49,159,recall_disagree_votes,19,208,434,452
65000210001,新北市,三芝區,八賢里,新北市第01選區,洪孟楷,中國國民黨,104,82,85,recall_disagree_votes,19,167,285,297
10015020004,花蓮縣,鳳林鎮,鳳智里,花蓮縣第01選區,傅崐萁,中國國民黨,397,165,378,recall_disagree_votes,19,543,876,896
10009160008,雲林縣,臺西鄉,光華村,雲林縣第01選區,丁學忠,中國國民黨,199,133,180,recall_disagree_votes,19,313,621,630
10017060007,基隆市,安樂區,永康里,基隆市第01選區,林沛祥,中國國民黨,510,387,491,recall_disagree_votes,19,878,1740,1780
10009160001,雲林縣,臺西鄉,台西村,雲林縣第01選區,丁學忠,中國國民黨,457,159,438,recall_disagree_votes,19,597,1092,1145
10008070007,南投縣,鹿谷鄉,竹豐村,南投縣第02選區,游顥,中國國民黨,353,95,334,recall_disagree_votes,19,429,803,845
10015070003,花蓮縣,光復鄉,大平村,花蓮縣第01選區,傅崐萁,中國國民黨,82,59,64,recall_disagree_votes,18,123,260,264
10008080017,南投縣,中寮鄉,永芳村,南投縣第01選區,馬文君,中國國民黨,180,62,162,recall_disagree_votes,18,224,409,427
10008080007,南投縣,中寮鄉,復興村,南投縣第01選區,馬文君,中國國民黨,99,38,81,recall_disagree_votes,18,119,246,260
10015050011,花蓮縣,吉安鄉,稻香村,花蓮縣第01選區,傅崐萁,中國國民黨,1094,706,1076,recall_disagree_votes,18,1782,2820,2861
10015110001,花蓮縣,秀林鄉,崇德村,花蓮縣第01選區,傅崐萁,中國國民黨,113,50,95,recall_disagree_votes,18,145,275,278
65000250001,新北市,雙溪區,雙溪里,新北市第12選區,廖先翔,中國國民黨,151,61,133,recall_disagree_votes,18,194,396,406
10008020016,南投縣,埔里鎮,成功里,南投縣第01選區,馬文君,中國國民黨,103,34,85,recall_disagree_votes,18,119,267,271
65000240002,新北市,平溪區,菁桐里,新北市第12選區,廖先翔,中國國民黨,72,40,54,recall_disagree_votes,18,94,227,225
10017020015,基隆市,七堵區,友一里,基隆市第01選區,林沛祥,中國國民黨,680,393,662,recall_disagree_votes,18,1055,1983,1931
10009160015,雲林縣,臺西鄉,五港村,雲林縣第01選區,丁學忠,中國國民黨,527,251,509,recall_disagree_votes,18,760,1623,1678
10015040007,花蓮縣,新城鄉,嘉新村,花蓮縣第01選區,傅崐萁,中國國民黨,251,119,234,recall_disagree_votes,17,353,664,664
68000020028,桃園市,中壢區,中壢里,桃園市第03選區,魯明哲,中國國民黨,230,149,213,recall_disagree_votes,17,362,674,669
10008130011,南投縣,仁愛鄉,春陽村,南投縣第01選區,馬文君,中國國民黨,31,5,14,recall_disagree_votes,17,19,71,76
10015100007,花蓮縣,富里鄉,石牌村,花蓮縣第01選區,傅崐萁,中國國民黨,328,125,311,recall_disagree_votes,17,436,812,803
10004100009,新竹縣,寶山鄉,油田村,新竹縣第02選區,林思銘,中國國民黨,245,71,228,recall_disagree_votes,17,299,546,559
10004020001,新竹縣,竹東鎮,上坪里,新竹縣第02選區,林思銘,中國國民黨,104,28,87,recall_disagree_votes,17,115,247,262
10004090005,新竹縣,北埔鄉,南埔村,新竹縣第02選區,林思銘,中國國民黨,158,46,142,recall_disagree_votes,16,188,339,357
10009150008,雲林縣,褒忠鄉,龍岩村,雲林縣第01選區,丁學忠,中國國民黨,347,196,331,recall_disagree_votes,16,527,1062,1113
10008110012,南投縣,水里鄉,新山村,南投縣第02選區,游顥,中國國民黨,59,13,43,recall_disagree_votes,16,56,176,180
10015040003,花蓮縣,新城鄉,康樂村,花蓮縣第01選區,傅崐萁,中國國民黨,632,405,616,recall_disagree_votes,16,1021,1628,1694
10004020018,新竹縣,竹東鎮,柯湖里,新竹縣第02選區,林思銘,中國國民黨,222,77,206,recall_disagree_votes,16,283,552,558
65000120026,新北市,瑞芳區,石山里,新北市第12選區,廖先翔,中國國民黨,92,51,76,recall_disagree_votes,16,127,272,290
68000020039,桃園市,中壢區,龍東里,桃園市第03選區,魯明哲,中國國民黨,2130,567,2114,recall_disagree_votes,16,2681,4708,4684
10008130003,南投縣,仁愛鄉,互助村,南投縣第01選區,馬文君,中國國民黨,49,6,33,recall_disagree_votes,16,39,108,110
65000240005,新北市,平溪區,平溪里,新北市第12選區,廖先翔,中國國民黨,79,41,63,recall_disagree_votes,16,104,219,217
10017070011,基隆市,信義區,信綠里,基隆市第01選區,林沛祥,中國國民黨,604,384,588,recall_disagree_votes,16,972,1790,1857
10009030019,雲林縣,虎尾鎮,堀頭里,雲林縣第01選區,丁學忠,中國國民黨,378,172,363,recall_disagree_votes,15,535,839,817
68000130005,桃園市,復興區,長興里,桃園市第06選區,邱若華,中國國民黨,44,13,29,recall_disagree_votes,15,42,119,128
10008050007,南投縣,集集鎮,吳厝里,南投縣第02選區,游顥,中國國民黨,313,110,298,recall_disagree_votes,15,408,785,818
10017050006,基隆市,中山區,中興里,基隆市第01選區,林沛祥,中國國民黨,395,265,380,recall_disagree_votes,15,645,1128,1155
65000120023,新北市,瑞芳區,新山里,新北市第12選區,廖先翔,中國國民黨,107,65,92,recall_disagree_votes,15,157,317,341
68000040041,桃園市,楊梅區,頭湖里,桃園市第02選區,涂權吉,中國國民黨,1076,549,1061,recall_disagree_votes,15,1610,2983,2721
10015070008,花蓮縣,光復鄉,大興村,花蓮縣第01選區,傅崐萁,中國國民黨,78,47,63,recall_disagree_votes,15,110,224,233
10015070002,花蓮縣,光復鄉,大華村,花蓮縣第01選區,傅崐萁,中國國民黨,267,231,252,recall_disagree_votes,15,483,817,825
10017010023,基隆市,中正區,中正里,基隆市第01選區,林沛祥,中國國民黨,406,270,391,recall_disagree_votes,15,661,1437,1485
10009170007,雲林縣,元長鄉,五塊村,雲林縣第01選區,丁學忠,中國國民黨,295,157,280,recall_disagree_votes,15,437,806,828
10015060003,花蓮縣,壽豐鄉,豐山村,花蓮縣第01選區,傅崐萁,中國國民黨,569,328,555,recall_disagree_votes,14,883,1508,1563
10004080004,新竹縣,橫山鄉,豐鄉村,新竹縣第02選區,林思銘,中國國民黨,66,29,52,recall_disagree_votes,14,81,210,217
10015060012,花蓮縣,壽豐鄉,米棧村,花蓮縣第01選區,傅崐萁,中國國民黨,62,24,48,recall_disagree_votes,14,72,113,121
10017010012,基隆市,中正區,砂灣里,基隆市第01選區,林沛祥,中國國民黨,606,342,592,recall_disagree_votes,14,934,1861,1870
10015020006,花蓮縣,鳳林鎮,山興里,花蓮縣第01選區,傅崐萁,中國國民黨,55,34,41,recall_disagree_votes,14,75,132,150
63000080015,臺北市,文山區,興家里,臺北市第08選區,賴士葆,中國國民黨,2351,1254,2337,recall_disagree_votes,14,3591,5912,6028
10015070010,花蓮縣,光復鄉,大豐村,花蓮縣第01選區,傅崐萁,中國國民黨,119,72,105,recall_disagree_votes,14,177,325,354
10009160007,雲林縣,臺西鄉,泉州村,雲林縣第01選區,丁學忠,中國國民黨,172,83,158,recall_disagree_votes,14,241,536,564
10009170017,雲林縣,元長鄉,鹿南村,雲林縣第01選區,丁學忠,中國國民黨,254,135,240,recall_disagree_votes,14,375,763,780
10015040008,花蓮縣,新城鄉,大漢村,花蓮縣第01選區,傅崐萁,中國國民黨,529,307,516,recall_disagree_votes,13,823,1361,1394
10017040010,基隆市,仁愛區,博愛里,基隆市第01選區,林沛祥,中國國民黨,416,342,403,recall_disagree_votes,13,745,1281,1355
10015020001,花蓮縣,鳳林鎮,鳳仁里,花蓮縣第01選區,傅崐萁,中國國民黨,433,236,420,recall_disagree_votes,13,656,1052,1062
65000240012,新北市,平溪區,新寮里,新北市第12選區,廖先翔,中國國民黨,52,29,39,recall_disagree_votes,13,68,141,142
10008050005,南投縣,集集鎮,隘寮里,南投縣第02選區,游顥,中國國民黨,146,70,133,recall_disagree_votes,13,203,426,438
10015100008,花蓮縣,富里鄉,明里村,花蓮縣第01選區,傅崐萁,中國國民黨,129,44,116,recall_disagree_votes,13,160,316,319
10017050014,基隆市,中山區,仙洞里,基隆市第01選區,林沛祥,中國國民黨,153,102,140,recall_disagree_votes,13,242,477,521
10015110004,花蓮縣,秀林鄉,水源村,花蓮縣第01選區,傅崐萁,中國國民黨,69,22,56,recall_disagree_votes,13,78,138,148
10015030009,花蓮縣,玉里鎮,東豐里,花蓮縣第01選區,傅崐萁,中國國民黨,93,41,80,recall_disagree_votes,13,121,256,268
10015060014,花蓮縣,壽豐鄉,水璉村,花蓮縣第01選區,傅崐萁,中國國民黨,80,54,67,recall_disagree_votes,13,121,235,267
10008130013,南投縣,仁愛鄉,萬豐村,南投縣第01選區,馬文君,中國國民黨,25,3,13,recall_disagree_votes,12,16,52,50
10004090008,新竹縣,北埔鄉,南坑村,新竹縣第02選區,林思銘,中國國民黨,130,31,118,recall_disagree_votes,12,149,303,301
10015090003,花蓮縣,瑞穗鄉,瑞良村,花蓮縣第01選區,傅崐萁,中國國民黨,111,74,99,recall_disagree_votes,12,173,310,323
10015030010,花蓮縣,玉里鎮,觀音里,花蓮縣第01選區,傅崐萁,中國國民黨,271,126,259,recall_disagree_votes,12,385,738,753
10015110007,花蓮縣,秀林鄉,景美村,花蓮縣第01選區,傅崐萁,中國國民黨,55,32,43,recall_disagree_votes,12,75,146,155
10015080001,花蓮縣,豐濱鄉,豐濱村,花蓮縣第01選區,傅崐萁,中國國民黨,95,87,83,recall_disagree_votes,12,170,317,338
10017060004,基隆市,安樂區,定邦里,基隆市第01選區,林沛祥,中國國民黨,307,228,296,recall_disagree_votes,11,524,900,922
10004020022,新竹縣,竹東鎮,南華里,新竹縣第02選區,林思銘,中國國民黨,368,117,357,recall_disagree_votes,11,474,971,983
65000030036,新北市,中和區,東南里,新北市第08選區,張智倫,中國國民黨,1561,506,1550,recall_disagree_votes,11,2056,3598,3551
10015070011,花蓮縣,光復鄉,東富村,花蓮縣第01選區,傅崐萁,中國國民黨,42,21,31,recall_disagree_votes,11,52,109,124
10004020006,新竹縣,竹東鎮,上舘里,新竹縣第02選區,林思銘,中國國民黨,3050,888,3039,recall_disagree_votes,11,3927,8399,8314
10015060005,花蓮縣,壽豐鄉,豐坪村,花蓮縣第01選區,傅崐萁,中國國民黨,253,163,242,recall_disagree_votes,11,405,632,635
10015090010,花蓮縣,瑞穗鄉,富民村,花蓮縣第01選區,傅崐萁,中國國民黨,62,31,52,recall_disagree_votes,10,83,170,175
10015070009,花蓮縣,光復鄉,大富村,花蓮縣第01選區,傅崐萁,中國國民黨,77,70,67,recall_disagree_votes,10,137,240,258
10015020009,花蓮縣,鳳林鎮,南平里,花蓮縣第01選區,傅崐萁,中國國民黨,179,116,169,recall_disagree_votes,10,285,465,483
10008130008,南投縣,仁愛鄉,親愛村,南投縣第01選區,馬文君,中國國民黨,37,5,27,recall_disagree_votes,10,32,100,93
10015050016,花蓮縣,吉安鄉,仁安村,花蓮縣第01選區,傅崐萁,中國國民黨,567,466,557,recall_disagree_votes,10,1023,1758,1785
10008130006,南投縣,仁愛鄉,發祥村,南投縣第01選區,馬文君,中國國民黨,22,5,12,recall_disagree_votes,10,17,75,69
68000060008,桃園市,大園區,大海里,桃園市第02選區,涂權吉,中國國民黨,247,164,237,recall_disagree_votes,10,401,625,693
10015040005,花蓮縣,新城鄉,佳林村,花蓮縣第01選區,傅崐萁,中國國民黨,264,177,254,recall_disagree_votes,10,431,692,705
68000020069,桃園市,中壢區,德義里,桃園市第03選區,魯明哲,中國國民黨,854,546,844,recall_disagree_votes,10,1390,2441,2431
68000130010,桃園市,復興區,高義里,桃園市第06選區,邱若華,中國國民黨,13,9,3,recall_disagree_votes,10,12,67,68
10009160003,雲林縣,臺西鄉,海南村,雲林縣第01選區,丁學忠,中國國民黨,352,152,342,recall_disagree_votes,10,494,1009,1041
10004100002,新竹縣,寶山鄉,大崎村,新竹縣第02選區,林思銘,中國國民黨,676,242,666,recall_disagree_votes,10,908,1917,1816
10015090006,花蓮縣,瑞穗鄉,舞鶴村,花蓮縣第01選區,傅崐萁,中國國民黨,129,84,120,recall_disagree_votes,9,204,364,378
68000100042,桃園市,平鎮區,復興里,桃園市第05選區,呂玉玲,中國國民黨,1585,1180,1576,recall_disagree_votes,9,2756,4655,4753
10015100004,花蓮縣,富里鄉,新興村,花蓮縣第01選區,傅崐萁,中國國民黨,156,61,147,recall_disagree_votes,9,208,412,430
10009180015,雲林縣,四湖鄉,廣溝村,雲林縣第01選區,丁學忠,中國國民黨,134,78,125,recall_disagree_votes,9,203,587,622
10015110008,花蓮縣,秀林鄉,佳民村,花蓮縣第01選區,傅崐萁,中國國民黨,53,26,44,recall_disagree_votes,9,70,134,134
10015070004,花蓮縣,光復鄉,大馬村,花蓮縣第01選區,傅崐萁,中國國民黨,86,55,77,recall_disagree_votes,9,132,258,271
10004020004,新竹縣,竹東鎮,員崠里,新竹縣第02選區,林思銘,中國國民黨,766,180,757,recall_disagree_votes,9,937,2009,2007
10008110010,南投縣,水里鄉,車埕村,南投縣第02選區,游顥,中國國民黨,135,55,126,recall_disagree_votes,9,181,394,410
10015070012,花蓮縣,光復鄉,西富村,花蓮縣第01選區,傅崐萁,中國國民黨,89,47,80,recall_disagree_votes,9,127,256,267
10008120007,南投縣,信義鄉,羅娜村,南投縣第02選區,游顥,中國國民黨,86,32,77,recall_disagree_votes,9,109,225,243
10008130014,南投縣,仁愛鄉,榮興村,南投縣第01選區,馬文君,中國國民黨,17,0,8,recall_disagree_votes,9,8,29,37
10004130002,新竹縣,五峰鄉,花園村,新竹縣第02選區,林思銘,中國國民黨,27,11,18,recall_disagree_votes,9,29,78,85
10014090009,臺東縣,太麻里鄉,多良村,臺東縣第01選區,黃建賓,中國國民黨,44,18,35,recall_disagree_votes,9,53,139,141
65000120001,新北市,瑞芳區,龍潭里,新北市第12選區,廖先翔,中國國民黨,224,133,216,recall_disagree_votes,8,349,631,664
63000050009,臺北市,中正區,螢圃里,臺北市第08選區,賴士葆,中國國民黨,1571,1091,1563,recall_disagree_votes,8,2654,4545,4618
10009180009,雲林縣,四湖鄉,飛沙村,雲林縣第01選區,丁學忠,中國國民黨,193,104,185,recall_disagree_votes,8,289,725,768
10015090007,花蓮縣,瑞穗鄉,鶴岡村,花蓮縣第01選區,傅崐萁,中國國民黨,93,42,85,recall_disagree_votes,8,127,217,227
10017050023,基隆市,中山區,和平里,基隆市第01選區,林沛祥,中國國民黨,170,81,163,recall_disagree_votes,7,244,409,417
10017040022,基隆市,仁愛區,獅球里,基隆市第01選區,林沛祥,中國國民黨,264,198,257,recall_disagree_votes,7,455,897,913
10014100002,臺東縣,大武鄉,大鳥村,臺東縣第01選區,黃建賓,中國國民黨,14,7,7,recall_disagree_votes,7,14,35,36
10015100011,花蓮縣,富里鄉,豐南村,花蓮縣第01選區,傅崐萁,中國國民黨,78,37,71,recall_disagree_votes,7,108,215,218
10014090008,臺東縣,太麻里鄉,金崙村,臺東縣第01選區,黃建賓,中國國民黨,55,20,48,recall_disagree_votes,7,68,207,229
10015070014,花蓮縣,光復鄉,北富村,花蓮縣第01選區,傅崐萁,中國國民黨,45,23,38,recall_disagree_votes,7,61,140,139
68000080004,桃園市,八德區,瑞發里,桃園市第06選區,邱若華,中國國民黨,1048,607,1041,recall_disagree_votes,7,1648,2873,2901
10009140001,雲林縣,東勢鄉,東南村,雲林縣第01選區,丁學忠,中國國民黨,471,270,464,recall_disagree_votes,7,734,1362,1368
10009180019,雲林縣,四湖鄉,溪尾村,雲林縣第01選區,丁學忠,中國國民黨,182,105,175,recall_disagree_votes,7,280,646,680
10008130017,南投縣,仁愛鄉,德鹿谷村,南投縣第01選區,馬文君,中國國民黨,9,0,2,recall_disagree_votes,7,2,24,26
65000030011,新北市,中和區,漳和里,新北市第08選區,張智倫,中國國民黨,1010,829,1003,recall_disagree_votes,7,1832,3332,3318
10015110005,花蓮縣,秀林鄉,銅門村,花蓮縣第01選區,傅崐萁,中國國民黨,29,15,22,recall_disagree_votes,7,37,75,78
10015030012,花蓮縣,玉里鎮,春日里,花蓮縣第01選區,傅崐萁,中國國民黨,84,55,77,recall_disagree_votes,7,132,280,290
10008110002,南投縣,水里鄉,農富村,南投縣第02選區,游顥,中國國民黨,139,79,132,recall_disagree_votes,7,211,379,391
10008130002,南投縣,仁愛鄉,中正村,南投縣第01選區,馬文君,中國國民黨,26,5,19,recall_disagree_votes,7,24,65,68
10015110006,花蓮縣,秀林鄉,文蘭村,花蓮縣第01選區,傅崐萁,中國國民黨,39,15,32,recall_disagree_votes,7,47,87,87
10015030013,花蓮縣,玉里鎮,德武里,花蓮縣第01選區,傅崐萁,中國國民黨,18,3,11,recall_disagree_votes,7,14,42,47
10015120001,花蓮縣,萬榮鄉,西林村,花蓮縣第01選區,傅崐萁,中國國民黨,17,5,10,recall_disagree_votes,7,15,35,45
10008130012,南投縣,仁愛鄉,精英村,南投縣第01選區,馬文君,中國國民黨,36,10,29,recall_disagree_votes,7,39,92,102
10015110003,花蓮縣,秀林鄉,秀林村,花蓮縣第01選區,傅崐萁,中國國民黨,47,27,41,recall_disagree_votes,6,68,141,143
10015130005,花蓮縣,卓溪鄉,卓清村,花蓮縣第01選區,傅崐萁,中國國民黨,17,6,11,recall_disagree_votes,6,17,45,48
10017010011,基隆市,中正區,真砂里,基隆市第01選區,林沛祥,中國國民黨,390,249,384,recall_disagree_votes,6,633,1191,1222
10008120015,南投縣,信義鄉,卡里布安村,南投縣第02選區,游顥,中國國民黨,25,2,19,recall_disagree_votes,6,21,45,53
65000270001,新北市,金山區,和平里,新北市第12選區,廖先翔,中國國民黨,140,89,134,recall_disagree_votes,6,223,404,418
68000020067,桃園市,中壢區,龍安里,桃園市第06選區,邱若華,中國國民黨,915,257,909,recall_disagree_votes,6,1166,1854,1896
10015030007,花蓮縣,玉里鎮,長良里,花蓮縣第01選區,傅崐萁,中國國民黨,99,50,93,recall_disagree_votes,6,143,299,308
10008100003,南投縣,國姓鄉,大旗村,南投縣第01選區,馬文君,中國國民黨,207,90,201,recall_disagree_votes,6,291,614,618
65000120006,新北市,瑞芳區,龍安里,新北市第12選區,廖先翔,中國國民黨,189,92,183,recall_disagree_votes,6,275,521,522
10008130001,南投縣,仁愛鄉,法治村,南投縣第01選區,馬文君,中國國民黨,13,4,8,recall_disagree_votes,5,12,32,40
10015030011,花蓮縣,玉里鎮,松浦里,花蓮縣第01選區,傅崐萁,中國國民黨,97,57,92,recall_disagree_votes,5,149,298,304
10014100005,臺東縣,大武鄉,南興村,臺東縣第01選區,黃建賓,中國國民黨,58,42,53,recall_disagree_votes,5,95,203,215
10015120004,花蓮縣,萬榮鄉,明利村,花蓮縣第01選區,傅崐萁,中國國民黨,19,7,14,recall_disagree_votes,5,21,44,45
10015050012,花蓮縣,吉安鄉,南昌村,花蓮縣第01選區,傅崐萁,中國國民黨,1008,743,1003,recall_disagree_votes,5,1746,2840,2831
10015060001,花蓮縣,壽豐鄉,樹湖村,花蓮縣第01選區,傅崐萁,中國國民黨,106,60,101,recall_disagree_votes,5,161,269,281
10004080003,新竹縣,橫山鄉,南昌村,新竹縣第02選區,林思銘,中國國民黨,62,16,57,recall_disagree_votes,5,73,155,154
63000080003,臺北市,文山區,景美里,臺北市第08選區,賴士葆,中國國民黨,1378,1011,1373,recall_disagree_votes,5,2384,4100,4155
65000120024,新北市,瑞芳區,瓜山里,新北市第12選區,廖先翔,中國國民黨,67,27,62,recall_disagree_votes,5,89,156,160
68000130004,桃園市,復興區,霞雲里,桃園市第06選區,邱若華,中國國民黨,38,11,33,recall_disagree_votes,5,44,95,95
10009160010,雲林縣,臺西鄉,山寮村,雲林縣第01選區,丁學忠,中國國民黨,245,86,240,recall_disagree_votes,5,326,735,779
10017070006,基隆市,信義區,義和里,基隆市第01選區,林沛祥,中國國民黨,392,227,387,recall_disagree_votes,5,614,1441,1469
10008130016,南投縣,仁愛鄉,都達村,南投縣第01選區,馬文君,中國國民黨,8,1,3,recall_disagree_votes,5,4,26,23
10015120002,花蓮縣,萬榮鄉,見晴村,花蓮縣第01選區,傅崐萁,中國國民黨,6,1,2,recall_disagree_votes,4,3,20,23
10017010009,基隆市,中正區,中砂里,基隆市第01選區,林沛祥,中國國民黨,376,277,372,recall_disagree_votes,4,649,1601,1569
10015080005,花蓮縣,豐濱鄉,靜浦村,花蓮縣第01選區,傅崐萁,中國國民黨,17,3,13,recall_disagree_votes,4,16,50,53
10017010017,基隆市,中正區,和憲里,基隆市第01選區,林沛祥,中國國民黨,208,102,204,recall_disagree_votes,4,306,606,629
68000020057,桃園市,中壢區,忠孝里,桃園市第03選區,魯明哲,中國國民黨,1600,870,1596,recall_disagree_votes,4,2466,4394,4421
10015030014,花蓮縣,玉里鎮,三民里,花蓮縣第01選區,傅崐萁,中國國民黨,232,132,228,recall_disagree_votes,4,360,683,715
10004090004,新竹縣,北埔鄉,水磜村,新竹縣第02選區,林思銘,中國國民黨,262,85,258,recall_disagree_votes,4,343,798,780
10017070001,基隆市,信義區,仁壽里,基隆市第01選區,林沛祥,中國國民黨,323,218,319,recall_disagree_votes,4,537,935,967
10014060006,臺東縣,池上鄉,錦園村,臺東縣第01選區,黃建賓,中國國民黨,57,50,53,recall_disagree_votes,4,103,285,302
65000240008,新北市,平溪區,望古里,新北市第12選區,廖先翔,中國國民黨,57,27,53,recall_disagree_votes,4,80,146,149
10015070006,花蓮縣,光復鄉,大進村,花蓮縣第01選區,傅崐萁,中國國民黨,118,70,114,recall_disagree_votes,4,184,305,311
10017050018,基隆市,中山區,西定里,基隆市第01選區,林沛祥,中國國民黨,253,176,250,recall_disagree_votes,3,426,810,834
10008120003,南投縣,信義鄉,潭南村,南投縣第02選區,游顥,中國國民黨,6,1,3,recall_disagree_votes,3,4,13,13
10014150004,臺東縣,達仁鄉,安朔村,臺東縣第01選區,黃建賓,中國國民黨,20,6,17,recall_disagree_votes,3,23,61,69
10015070013,花蓮縣,光復鄉,南富村,花蓮縣第01選區,傅崐萁,中國國民黨,30,35,27,recall_disagree_votes,3,62,105,99
10008130015,南投縣,仁愛鄉,翠華村,南投縣第01選區,馬文君,中國國民黨,35,12,32,recall_disagree_votes,3,44,160,165
10017020017,基隆市,七堵區,正明里,基隆市第01選區,林沛祥,中國國民黨,543,428,540,recall_disagree_votes,3,968,1766,1807
65000030048,新北市,中和區,景新里,新北市第08選區,張智倫,中國國民黨,1079,729,1076,recall_disagree_votes,3,1805,3032,3083
65000030087,新北市,中和區,民有里,新北市第08選區,張智倫,中國國民黨,748,604,745,recall_disagree_votes,3,1349,2334,2400
10015130002,花蓮縣,卓溪鄉,立山村,花蓮縣第01選區,傅崐萁,中國國民黨,11,0,8,recall_disagree_votes,3,8,25,27
10014140001,臺東縣,金峰鄉,新興村,臺東縣第01選區,黃建賓,中國國民黨,7,6,4,recall_disagree_votes,3,10,18,19
10015130006,花蓮縣,卓溪鄉,古風村,花蓮縣第01選區,傅崐萁,中國國民黨,22,4,20,recall_disagree_votes,2,24,48,50
10017050001,基隆市,中山區,新建里,基隆市第01選區,林沛祥,中國國民黨,211,186,209,recall_disagree_votes,2,395,726,737
10015130004,花蓮縣,卓溪鄉,卓溪村,花蓮縣第01選區,傅崐萁,中國國民黨,27,7,25,recall_disagree_votes,2,32,75,69
65000010093,新北市,板橋區,復興里,新北市第07選區,葉元之,中國國民黨,304,186,302,recall_disagree_votes,2,488,809,795
65000120021,新北市,瑞芳區,福住里,新北市第12選區,廖先翔,中國國民黨,62,25,60,recall_disagree_votes,2,85,140,153
10015090008,花蓮縣,瑞穗鄉,奇美村,花蓮縣第01選區,傅崐萁,中國國民黨,17,7,15,recall_disagree_votes,2,22,35,40
10014120006,臺東縣,海端鄉,加拿村,臺東縣第01選區,黃建賓,中國國民黨,9,1,7,recall_disagree_votes,2,8,19,24
10017050013,基隆市,中山區,文化里,基隆市第01選區,林沛祥,中國國民黨,284,181,283,recall_disagree_votes,1,464,1245,1194
10015120003,花蓮縣,萬榮鄉,萬榮村,花蓮縣第01選區,傅崐萁,中國國民黨,14,8,13,recall_disagree_votes,1,21,36,35
68000020006,桃園市,中壢區,成功里,桃園市第03選區,魯明哲,中國國民黨,1427,793,1426,recall_disagree_votes,1,2219,4167,4209
68000130003,桃園市,復興區,義盛里,桃園市第06選區,邱若華,中國國民黨,16,5,15,recall_disagree_votes,1,20,64,62
10015100003,花蓮縣,富里鄉,萬寧村,花蓮縣第01選區,傅崐萁,中國國民黨,165,50,164,recall_disagree_votes,1,214,423,433
10014150005,臺東縣,達仁鄉,森永村,臺東縣第01選區,黃建賓,中國國民黨,9,6,8,recall_disagree_votes,1,14,26,31
10008080008,南投縣,中寮鄉,中寮村,南投縣第01選區,馬文君,中國國民黨,226,70,225,recall_disagree_votes,1,295,571,581
10015120005,花蓮縣,萬榮鄉,馬遠村,花蓮縣第01選區,傅崐萁,中國國民黨,6,0,5,recall_disagree_votes,1,5,17,18
68000090011,桃園市,龍潭區,龍潭里,桃園市第05選區,呂玉玲,中國國民黨,590,421,589,recall_disagree_votes,1,1010,1691,1767
10015060015,花蓮縣,壽豐鄉,鹽寮村,花蓮縣第01選區,傅崐萁,中國國民黨,98,65,97,recall_disagree_votes,1,162,249,252
10015090005,花蓮縣,瑞穗鄉,瑞北村,花蓮縣第01選區,傅崐萁,中國國民黨,101,57,100,recall_disagree_votes,1,157,280,288
10008130005,南投縣,仁愛鄉,力行村,南投縣第01選區,馬文君,中國國民黨,5,0,4,recall_disagree_votes,1,4,17,19
10015020007,花蓮縣,鳳林鎮,大榮里,花蓮縣第01選區,傅崐萁,中國國民黨,341,238,340,recall_disagree_votes,1,578,1006,1010
10008110013,南投縣,水里鄉,郡坑村,南投縣第02選區,游顥,中國國民黨,109,39,109,recall_disagree_votes,0,148,294,308
10015020012,花蓮縣,鳳林鎮,森榮里,花蓮縣第01選區,傅崐萁,中國國民黨,24,2,24,recall_disagree_votes,0,26,39,42
10014140002,臺東縣,金峰鄉,正興村,臺東縣第01選區,黃建賓,中國國民黨,7,1,7,recall_disagree_votes,0,8,22,23
10008110004,南投縣,水里鄉,中央村,南投縣第02選區,游顥,中國國民黨,192,64,192,recall_disagree_votes,0,256,528,554
10015130001,花蓮縣,卓溪鄉,崙山村,花蓮縣第01選區,傅崐萁,中國國民黨,10,0,10,recall_disagree_votes,0,10,24,26
10014040003,臺東縣,卑南鄉,富山村,臺東縣第01選區,黃建賓,中國國民黨,80,39,80,recall_disagree_votes,0,119,274,284
10015060004,花蓮縣,壽豐鄉,豐裡村,花蓮縣第01選區,傅崐萁,中國國民黨,400,249,400,recall_disagree_votes,0,649,1035,1051
10014150003,臺東縣,達仁鄉,新化村,臺東縣第01選區,黃建賓,中國國民黨,5,0,6,recall_disagree_votes,-1,6,11,15
68000130007,桃園市,復興區,奎輝里,桃園市第06選區,邱若華,中國國民黨,14,5,15,recall_disagree_votes,-1,20,54,56
10015060013,花蓮縣,壽豐鄉,月眉村,花蓮縣第01選區,傅崐萁,中國國民黨,80,47,81,recall_disagree_votes,-1,128,220,216
10017050012,基隆市,中山區,協和里,基隆市第01選區,林沛祥,中國國民黨,404,299,405,recall_disagree_votes,-1,704,1332,1406
68000090016,桃園市,龍潭區,三和里,桃園市第05選區,呂玉玲,中國國民黨,255,175,256,recall_disagree_votes,-1,431,780,791
10004020005,新竹縣,竹東鎮,東寧里,新竹縣第02選區,林思銘,中國國民黨,1185,350,1186,recall_disagree_votes,-1,1536,3136,3150
10017070014,基隆市,信義區,東安里,基隆市第01選區,林沛祥,中國國民黨,805,494,806,recall_disagree_votes,-1,1300,2490,2570
10015060006,花蓮縣,壽豐鄉,共和村,花蓮縣第01選區,傅崐萁,中國國民黨,204,153,205,recall_disagree_votes,-1,358,572,567
10014150006,臺東縣,達仁鄉,南田村,臺東縣第01選區,黃建賓,中國國民黨,10,3,11,recall_disagree_votes,-1,14,42,35
68000100020,桃園市,平鎮區,貿易里,桃園市第05選區,呂玉玲,中國國民黨,821,348,823,recall_disagree_votes,-2,1171,1892,1857
68000080005,桃園市,八德區,瑞德里,桃園市第06選區,邱若華,中國國民黨,1133,567,1135,recall_disagree_votes,-2,1702,3105,3134
10008130004,南投縣,仁愛鄉,新生村,南投縣第01選區,馬文君,中國國民黨,17,2,19,recall_disagree_votes,-2,21,49,43
10014140004,臺東縣,金峰鄉,賓茂村,臺東縣第01選區,黃建賓,中國國民黨,3,0,5,recall_disagree_votes,-2,5,8,10
10004130003,新竹縣,五峰鄉,竹林村,新竹縣第02選區,林思銘,中國國民黨,11,1,13,recall_disagree_votes,-2,14,29,33
10014130002,臺東縣,延平鄉,永康村,臺東縣第01選區,黃建賓,中國國民黨,6,3,8,recall_disagree_votes,-2,11,19,22
10014130003,臺東縣,延平鄉,紅葉村,臺東縣第01選區,黃建賓,中國國民黨,7,2,9,recall_disagree_votes,-2,11,28,21
10017070005,基隆市,信義區,義民里,基隆市第01選區,林沛祥,中國國民黨,210,160,212,recall_disagree_votes,-2,372,694,720
10014130001,臺東縣,延平鄉,武陵村,臺東縣第01選區,黃建賓,中國國民黨,7,3,9,recall_disagree_votes,-2,12,27,24
10014100001,臺東縣,大武鄉,大竹村,臺東縣第01選區,黃建賓,中國國民黨,9,2,11,recall_disagree_votes,-2,13,51,52
10014140003,臺東縣,金峰鄉,嘉蘭村,臺東縣第01選區,黃建賓,中國國民黨,11,3,14,recall_disagree_votes,-3,17,36,46
65000250003,新北市,雙溪區,新基里,新北市第12選區,廖先翔,中國國民黨,208,133,211,recall_disagree_votes,-3,344,663,687
10015040009,花蓮縣,新城鄉,新秀村,花蓮縣第01選區,傅崐萁,中國國民黨,400,266,403,recall_disagree_votes,-3,669,1147,1036
10014140005,臺東縣,金峰鄉,歷坵村,臺東縣第01選區,黃建賓,中國國民黨,9,2,12,recall_disagree_votes,-3,14,19,19
10017040025,基隆市,仁愛區,明德里,基隆市第01選區,林沛祥,中國國民黨,205,139,208,recall_disagree_votes,-3,347,621,646
63000080011,臺北市,文山區,萬和里,臺北市第08選區,賴士葆,中國國民黨,1218,574,1221,recall_disagree_votes,-3,1795,2994,2831
10017020006,基隆市,七堵區,八德里,基隆市第01選區,林沛祥,中國國民黨,384,279,387,recall_disagree_votes,-3,666,1386,1409
10014120001,臺東縣,海端鄉,廣原村,臺東縣第01選區,黃建賓,中國國民黨,8,2,12,recall_disagree_votes,-4,14,48,50
10015120006,花蓮縣,萬榮鄉,紅葉村,花蓮縣第01選區,傅崐萁,中國國民黨,15,10,19,recall_disagree_votes,-4,29,54,56
63000080022,臺北市,文山區,興昌里,臺北市第08選區,賴士葆,中國國民黨,1951,1131,1955,recall_disagree_votes,-4,3086,5325,5377
10017060002,基隆市,安樂區,定國里,基隆市第01選區,林沛祥,中國國民黨,271,225,275,recall_disagree_votes,-4,500,934,941
68000130009,桃園市,復興區,羅浮里,桃園市第06選區,邱若華,中國國民黨,104,53,108,recall_disagree_votes,-4,161,360,359
10014060003,臺東縣,池上鄉,大坡村,臺東縣第01選區,黃建賓,中國國民黨,23,6,27,recall_disagree_votes,-4,33,86,90
63000080042,臺北市,文山區,興邦里,臺北市第08選區,賴士葆,中國國民黨,1696,802,1700,recall_disagree_votes,-4,2502,4063,4168
10015100001,花蓮縣,富里鄉,吳江村,花蓮縣第01選區,傅崐萁,中國國民黨,113,46,118,recall_disagree_votes,-5,164,300,320
10009180001,雲林縣,四湖鄉,四湖村,雲林縣第01選區,丁學忠,中國國民黨,513,293,518,recall_disagree_votes,-5,811,1661,1627
63000080018,臺北市,文山區,興安里,臺北市第08選區,賴士葆,中國國民黨,2123,1180,2128,recall_disagree_votes,-5,3308,5460,5502
10015050010,花蓮縣,吉安鄉,永興村,花蓮縣第01選區,傅崐萁,中國國民黨,864,525,870,recall_disagree_votes,-6,1395,2327,2268
65000030078,新北市,中和區,興南里,新北市第08選區,張智倫,中國國民黨,899,522,905,recall_disagree_votes,-6,1427,2556,2619
10015060008,花蓮縣,壽豐鄉,光榮村,花蓮縣第01選區,傅崐萁,中國國民黨,54,29,60,recall_disagree_votes,-6,89,139,137
10008030023,南投縣,草屯鎮,平林里,南投縣第01選區,馬文君,中國國民黨,420,132,426,recall_disagree_votes,-6,558,993,1028
10004110002,新竹縣,峨眉鄉,中盛村,新竹縣第02選區,林思銘,中國國民黨,207,83,213,recall_disagree_votes,-6,296,648,640
68000100019,桃園市,平鎮區,龍興里,桃園市第05選區,呂玉玲,中國國民黨,989,307,996,recall_disagree_votes,-7,1303,2251,2314
10017050007,基隆市,中山區,仁正里,基隆市第01選區,林沛祥,中國國民黨,224,123,231,recall_disagree_votes,-7,354,661,674
10017040002,基隆市,仁愛區,花崗里,基隆市第01選區,林沛祥,中國國民黨,293,220,300,recall_disagree_votes,-7,520,947,969
10004020019,新竹縣,竹東鎮,二重里,新竹縣第02選區,林思銘,中國國民黨,3957,1640,3965,recall_disagree_votes,-8,5605,12381,11334
10008110011,南投縣,水里鄉,新興村,南投縣第02選區,游顥,中國國民黨,177,47,185,recall_disagree_votes,-8,232,567,595
10017070007,基隆市,信義區,智慧里,基隆市第01選區,林沛祥,中國國民黨,220,150,228,recall_disagree_votes,-8,378,685,701
10014100003,臺東縣,大武鄉,大武村,臺東縣第01選區,黃建賓,中國國民黨,178,68,187,recall_disagree_votes,-9,255,545,599
10014120004,臺東縣,海端鄉,海端村,臺東縣第01選區,黃建賓,中國國民黨,16,6,25,recall_disagree_votes,-9,31,72,75
10017010024,基隆市,中正區,正濱里,基隆市第01選區,林沛祥,中國國民黨,242,156,251,recall_disagree_votes,-9,407,819,838
10014080002,臺東縣,長濱鄉,三間村,臺東縣第01選區,黃建賓,中國國民黨,54,31,63,recall_disagree_votes,-9,94,261,267
63000080006,臺北市,文山區,景華里,臺北市第08選區,賴士葆,中國國民黨,1581,1039,1590,recall_disagree_votes,-9,2629,4387,4572
10017070004,基隆市,信義區,義幸里,基隆市第01選區,林沛祥,中國國民黨,710,460,719,recall_disagree_votes,-9,1179,2104,2139
10008110009,南投縣,水里鄉,頂崁村,南投縣第02選區,游顥,中國國民黨,344,159,353,recall_disagree_votes,-9,512,1033,1046
65000030038,新北市,中和區,忠孝里,新北市第08選區,張智倫,中國國民黨,1458,711,1467,recall_disagree_votes,-9,2178,3916,3957
68000020030,桃園市,中壢區,仁祥里,桃園市第06選區,邱若華,中國國民黨,1048,385,1057,recall_disagree_votes,-9,1442,2616,2633
10015050015,花蓮縣,吉安鄉,東昌村,花蓮縣第01選區,傅崐萁,中國國民黨,1441,1004,1450,recall_disagree_votes,-9,2454,3982,3858
10018010008,新竹市,東區,下竹里,新竹市第01選區,鄭正鈐,中國國民黨,135,101,145,recall_disagree_votes,-10,246,393,417
10009160004,雲林縣,臺西鄉,海口村,雲林縣第01選區,丁學忠,中國國民黨,578,222,588,recall_disagree_votes,-10,810,1829,1888
10008030011,南投縣,草屯鎮,復興里,南投縣第01選區,馬文君,中國國民黨,860,508,870,recall_disagree_votes,-10,1378,2734,2762
10014080001,臺東縣,長濱鄉,樟原村,臺東縣第01選區,黃建賓,中國國民黨,54,17,64,recall_disagree_votes,-10,81,174,190
10015050005,花蓮縣,吉安鄉,慶豐村,花蓮縣第01選區,傅崐萁,中國國民黨,2078,1665,2088,recall_disagree_votes,-10,3753,5993,6000
10014040012,臺東縣,卑南鄉,東興村,臺東縣第01選區,黃建賓,中國國民黨,30,15,41,recall_disagree_votes,-11,56,115,119
10014060001,臺東縣,池上鄉,福文村,臺東縣第01選區,黃建賓,中國國民黨,193,124,205,recall_disagree_votes,-12,329,750,782
10017010013,基隆市,中正區,建國里,基隆市第01選區,林沛祥,中國國民黨,628,291,640,recall_disagree_votes,-12,931,1694,1742
10017070010,基隆市,信義區,禮東里,基隆市第01選區,林沛祥,中國國民黨,487,307,499,recall_disagree_votes,-12,806,1377,1396
10017050002,基隆市,中山區,安民里,基隆市第01選區,林沛祥,中國國民黨,293,233,305,recall_disagree_votes,-12,538,956,953
10009030029,雲林縣,虎尾鎮,東屯里,雲林縣第01選區,丁學忠,中國國民黨,383,230,395,recall_disagree_votes,-12,625,1176,1175
10017010001,基隆市,中正區,德義里,基隆市第01選區,林沛祥,中國國民黨,182,149,195,recall_disagree_votes,-13,344,597,620
10017020007,基隆市,七堵區,自強里,基隆市第01選區,林沛祥,中國國民黨,321,241,334,recall_disagree_votes,-13,575,1088,1097
10009050004,雲林縣,土庫鎮,越港里,雲林縣第01選區,丁學忠,中國國民黨,438,203,451,recall_disagree_votes,-13,654,1059,1022
68000090028,桃園市,龍潭區,東興里,桃園市第05選區,呂玉玲,中國國民黨,1345,584,1358,recall_disagree_votes,-13,1942,3589,3645
10004020023,新竹縣,竹東鎮,榮華里,新竹縣第02選區,林思銘,中國國民黨,2599,876,2613,recall_disagree_votes,-14,3489,7031,6784
68000020084,桃園市,中壢區,林森里,桃園市第03選區,魯明哲,中國國民黨,1347,834,1361,recall_disagree_votes,-14,2195,3738,3708
10014160003,臺東縣,蘭嶼鄉,紅頭村,臺東縣第01選區,黃建賓,中國國民黨,37,39,51,recall_disagree_votes,-14,90,296,320
10017020008,基隆市,七堵區,六堵里,基隆市第01選區,林沛祥,中國國民黨,652,487,667,recall_disagree_votes,-15,1154,2165,2167
10017010003,基隆市,中正區,信義里,基隆市第01選區,林沛祥,中國國民黨,226,207,242,recall_disagree_votes,-16,449,807,817
68000020083,桃園市,中壢區,自信里,桃園市第03選區,魯明哲,中國國民黨,2040,910,2057,recall_disagree_votes,-17,2967,5496,5297
10014070003,臺東縣,東河鄉,東河村,臺東縣第01選區,黃建賓,中國國民黨,60,32,77,recall_disagree_votes,-17,109,298,310
63000080031,臺北市,文山區,樟新里,臺北市第08選區,賴士葆,中國國民黨,1604,947,1621,recall_disagree_votes,-17,2568,4338,4419
10014090002,臺東縣,太麻里鄉,三和村,臺東縣第01選區,黃建賓,中國國民黨,124,95,141,recall_disagree_votes,-17,236,514,528
10015030003,花蓮縣,玉里鎮,永昌里,花蓮縣第01選區,傅崐萁,中國國民黨,265,150,282,recall_disagree_votes,-17,432,898,915
10017010008,基隆市,中正區,入船里,基隆市第01選區,林沛祥,中國國民黨,210,159,228,recall_disagree_votes,-18,387,767,701
68000080045,桃園市,八德區,龍友里,桃園市第06選區,邱若華,中國國民黨,906,236,924,recall_disagree_votes,-18,1160,1994,2001
10018010035,新竹市,東區,立功里,新竹市第01選區,鄭正鈐,中國國民黨,321,122,339,recall_disagree_votes,-18,461,789,832
10017020004,基隆市,七堵區,永平里,基隆市第01選區,林沛祥,中國國民黨,597,393,615,recall_disagree_votes,-18,1008,1756,1802
10015050007,花蓮縣,吉安鄉,福興村,花蓮縣第01選區,傅崐萁,中國國民黨,783,728,802,recall_disagree_votes,-19,1530,2382,2320
68000020041,桃園市,中壢區,興南里,桃園市第03選區,魯明哲,中國國民黨,1015,618,1034,recall_disagree_votes,-19,1652,3133,2918
10009180006,雲林縣,四湖鄉,施湖村,雲林縣第01選區,丁學忠,中國國民黨,294,155,313,recall_disagree_votes,-19,468,1088,1106
10017020001,基隆市,七堵區,長興里,基隆市第01選區,林沛祥,中國國民黨,1068,749,1088,recall_disagree_votes,-20,1837,3504,3522
10004090006,新竹縣,北埔鄉,大林村,新竹縣第02選區,林思銘,中國國民黨,276,72,296,recall_disagree_votes,-20,368,685,683
63000080028,臺北市,文山區,木新里,臺北市第08選區,賴士葆,中國國民黨,2405,1875,2425,recall_disagree_votes,-20,4300,8640,8545
68000020025,桃園市,中壢區,新興里,桃園市第03選區,魯明哲,中國國民黨,1199,811,1220,recall_disagree_votes,-21,2031,3486,3485
68000020079,桃園市,中壢區,健行里,桃園市第03選區,魯明哲,中國國民黨,1483,929,1504,recall_disagree_votes,-21,2433,4241,4242
10014060009,臺東縣,池上鄉,富興村,臺東縣第01選區,黃建賓,中國國民黨,61,30,82,recall_disagree_votes,-21,112,246,244
10017010006,基隆市,中正區,中船里,基隆市第01選區,林沛祥,中國國民黨,289,235,310,recall_disagree_votes,-21,545,1002,1058
68000090004,桃園市,龍潭區,高平里,桃園市第05選區,呂玉玲,中國國民黨,952,667,973,recall_disagree_votes,-21,1640,3041,3088
10017040004,基隆市,仁愛區,水錦里,基隆市第01選區,林沛祥,中國國民黨,505,317,526,recall_disagree_votes,-21,843,1596,1661
68000090027,桃園市,龍潭區,武漢里,桃園市第05選區,呂玉玲,中國國民黨,508,240,529,recall_disagree_votes,-21,769,1393,1392
65000030085,新北市,中和區,錦中里,新北市第08選區,張智倫,中國國民黨,1048,816,1070,recall_disagree_votes,-22,1886,3480,3528
10017010002,基隆市,中正區,正義里,基隆市第01選區,林沛祥,中國國民黨,341,265,363,recall_disagree_votes,-22,628,1098,1100
65000030044,新北市,中和區,外南里,新北市第08選區,張智倫,中國國民黨,1156,844,1178,recall_disagree_votes,-22,2022,6853,6650
68000020078,桃園市,中壢區,自治里,桃園市第03選區,魯明哲,中國國民黨,1567,495,1589,recall_disagree_votes,-22,2084,3516,3441
10017050015,基隆市,中山區,太白里,基隆市第01選區,林沛祥,中國國民黨,215,153,237,recall_disagree_votes,-22,390,737,790
10017040019,基隆市,仁愛區,崇文里,基隆市第01選區,林沛祥,中國國民黨,242,202,265,recall_disagree_votes,-23,467,833,831
10014080003,臺東縣,長濱鄉,忠勇村,臺東縣第01選區,黃建賓,中國國民黨,87,39,110,recall_disagree_votes,-23,149,365,364
10004100008,新竹縣,寶山鄉,寶山村,新竹縣第02選區,林思銘,中國國民黨,362,132,386,recall_disagree_votes,-24,518,1072,932
68000020053,桃園市,中壢區,普慶里,桃園市第03選區,魯明哲,中國國民黨,968,558,992,recall_disagree_votes,-24,1550,2565,2581
10009160011,雲林縣,臺西鄉,富琦村,雲林縣第01選區,丁學忠,中國國民黨,491,213,515,recall_disagree_votes,-24,728,1394,1435
10017040003,基隆市,仁愛區,虹橋里,基隆市第01選區,林沛祥,中國國民黨,410,273,435,recall_disagree_votes,-25,708,1348,1380
66000080025,臺中市,北屯區,新平里,臺中市第05選區,黃健豪,中國國民黨,1571,888,1596,recall_disagree_votes,-25,2484,4572,4115
65000030010,新北市,中和區,枋寮里,新北市第08選區,張智倫,中國國民黨,996,747,1021,recall_disagree_votes,-25,1768,3145,3161
63000080005,臺北市,文山區,景仁里,臺北市第08選區,賴士葆,中國國民黨,1712,1128,1737,recall_disagree_votes,-25,2865,4748,4647
65000030018,新北市,中和區,福和里,新北市第08選區,張智倫,中國國民黨,974,750,1000,recall_disagree_votes,-26,1750,3071,3103
10017050005,基隆市,中山區,民治里,基隆市第01選區,林沛祥,中國國民黨,235,169,261,recall_disagree_votes,-26,430,720,729
10017040023,基隆市,仁愛區,書院里,基隆市第01選區,林沛祥,中國國民黨,299,229,325,recall_disagree_votes,-26,554,1050,1057
63000080024,臺北市,文山區,華興里,臺北市第08選區,賴士葆,中國國民黨,2630,1640,2656,recall_disagree_votes,-26,4296,7339,7220
65000030053,新北市,中和區,錦昌里,新北市第08選區,張智倫,中國國民黨,670,430,697,recall_disagree_votes,-27,1127,1980,1982
10014020008,臺東縣,成功鎮,信義里,臺東縣第01選區,黃建賓,中國國民黨,76,68,103,recall_disagree_votes,-27,171,386,404
10017070015,基隆市,信義區,孝岡里,基隆市第01選區,林沛祥,中國國民黨,393,235,421,recall_disagree_votes,-28,656,1232,1259
65000030042,新北市,中和區,內南里,新北市第08選區,張智倫,中國國民黨,1402,824,1430,recall_disagree_votes,-28,2254,4099,4186
68000020011,桃園市,中壢區,龍興里,桃園市第03選區,魯明哲,中國國民黨,1408,828,1436,recall_disagree_votes,-28,2264,4037,4104
10014090007,臺東縣,太麻里鄉,香蘭村,臺東縣第01選區,黃建賓,中國國民黨,91,57,119,recall_disagree_votes,-28,176,356,375
10017040001,基隆市,仁愛區,林泉里,基隆市第01選區,林沛祥,中國國民黨,422,320,450,recall_disagree_votes,-28,770,1569,1571
10018020035,新竹市,北區,大鵬里,新竹市第01選區,鄭正鈐,中國國民黨,43,22,72,recall_disagree_votes,-29,94,209,185
10014020003,臺東縣,成功鎮,三仙里,臺東縣第01選區,黃建賓,中國國民黨,67,43,96,recall_disagree_votes,-29,139,377,373
63000080013,臺北市,文山區,興豐里,臺北市第08選區,賴士葆,中國國民黨,1435,965,1465,recall_disagree_votes,-30,2430,4024,4043
10017010007,基隆市,中正區,正船里,基隆市第01選區,林沛祥,中國國民黨,355,222,385,recall_disagree_votes,-30,607,1091,1094
68000030016,桃園市,大溪區,僑愛里,桃園市第06選區,邱若華,中國國民黨,1092,237,1122,recall_disagree_votes,-30,1359,2360,2310
63000080008,臺北市,文山區,萬祥里,臺北市第08選區,賴士葆,中國國民黨,1206,911,1236,recall_disagree_votes,-30,2147,3608,3639
65000030082,新北市,中和區,吉興里,新北市第08選區,張智倫,中國國民黨,884,482,914,recall_disagree_votes,-30,1396,2554,2534
65000030068,新北市,中和區,民生里,新北市第08選區,張智倫,中國國民黨,1112,975,1143,recall_disagree_votes,-31,2118,3636,3627
68000020023,桃園市,中壢區,篤行里,桃園市第06選區,邱若華,中國國民黨,929,469,960,recall_disagree_votes,-31,1429,2618,2575
68000020063,桃園市,中壢區,至善里,桃園市第03選區,魯明哲,中國國民黨,1397,563,1428,recall_disagree_votes,-31,1991,3682,3615
10017050021,基隆市,中山區,中和里,基隆市第01選區,林沛祥,中國國民黨,1628,996,1659,recall_disagree_votes,-31,2655,5234,5215
10014090006,臺東縣,太麻里鄉,大王村,臺東縣第01選區,黃建賓,中國國民黨,227,189,258,recall_disagree_votes,-31,447,997,1032
10017010010,基隆市,中正區,正砂里,基隆市第01選區,林沛祥,中國國民黨,728,427,760,recall_disagree_votes,-32,1187,2115,2100
68000020087,桃園市,中壢區,興華里,桃園市第03選區,魯明哲,中國國民黨,1942,1067,1974,recall_disagree_votes,-32,3041,5540,5584
10017070003,基隆市,信義區,義昭里,基隆市第01選區,林沛祥,中國國民黨,374,285,406,recall_disagree_votes,-32,691,1198,1233
10017020003,基隆市,七堵區,富民里,基隆市第01選區,林沛祥,中國國民黨,1085,679,1118,recall_disagree_votes,-33,1797,3209,3274
10017070018,基隆市,信義區,孝賢里,基隆市第01選區,林沛祥,中國國民黨,1146,694,1180,recall_disagree_votes,-34,1874,3309,3336
68000100022,桃園市,平鎮區,中正里,桃園市第05選區,呂玉玲,中國國民黨,708,216,742,recall_disagree_votes,-34,958,1577,1568
63000080023,臺北市,文山區,試院里,臺北市第08選區,賴士葆,中國國民黨,2141,1243,2176,recall_disagree_votes,-35,3419,5569,5542
63000080010,臺北市,文山區,萬年里,臺北市第08選區,賴士葆,中國國民黨,1430,1075,1465,recall_disagree_votes,-35,2540,4226,4357
68000020012,桃園市,中壢區,仁美里,桃園市第03選區,魯明哲,中國國民黨,1976,991,2011,recall_disagree_votes,-35,3002,5347,5329
10017050010,基隆市,中山區,居仁里,基隆市第01選區,林沛祥,中國國民黨,346,201,381,recall_disagree_votes,-35,582,1160,1183
63000080043,臺北市,文山區,樟樹里,臺北市第08選區,賴士葆,中國國民黨,1270,864,1305,recall_disagree_votes,-35,2169,3689,3745
65000030017,新北市,中和區,瓦磘里,新北市第08選區,張智倫,中國國民黨,1405,1133,1440,recall_disagree_votes,-35,2573,4657,4743
63000080035,臺北市,文山區,萬興里,臺北市第08選區,賴士葆,中國國民黨,2252,1652,2288,recall_disagree_votes,-36,3940,6743,6754
65000030005,新北市,中和區,中正里,新北市第08選區,張智倫,中國國民黨,965,781,1001,recall_disagree_votes,-36,1782,3259,3284
68000090031,桃園市,龍潭區,富林里,桃園市第05選區,呂玉玲,中國國民黨,1243,510,1279,recall_disagree_votes,-36,1789,3158,3209
65000030015,新北市,中和區,福美里,新北市第08選區,張智倫,中國國民黨,1182,918,1219,recall_disagree_votes,-37,2137,3619,3709
68000030015,桃園市,大溪區,仁義里,桃園市第06選區,邱若華,中國國民黨,890,327,928,recall_disagree_votes,-38,1255,2433,2463
10018030019,新竹市,香山區,南隘里,新竹市第01選區,鄭正鈐,中國國民黨,225,181,264,recall_disagree_votes,-39,445,771,744
68000080006,桃園市,八德區,瑞祥里,桃園市第06選區,邱若華,中國國民黨,1039,470,1078,recall_disagree_votes,-39,1548,2816,2867
10017050008,基隆市,中山區,健民里,基隆市第01選區,林沛祥,中國國民黨,286,246,325,recall_disagree_votes,-39,571,1047,1074
10017040021,基隆市,仁愛區,兆連里,基隆市第01選區,林沛祥,中國國民黨,208,144,247,recall_disagree_votes,-39,391,665,669
10014030007,臺東縣,關山鎮,月眉里,臺東縣第01選區,黃建賓,中國國民黨,90,83,130,recall_disagree_votes,-40,213,506,536
68000020017,桃園市,中壢區,普義里,桃園市第03選區,魯明哲,中國國民黨,1405,793,1446,recall_disagree_votes,-41,2239,5676,5467
10017010004,基隆市,中正區,義重里,基隆市第01選區,林沛祥,中國國民黨,269,181,310,recall_disagree_votes,-41,491,887,889
63000080019,臺北市,文山區,興福里,臺北市第08選區,賴士葆,中國國民黨,1499,1101,1540,recall_disagree_votes,-41,2641,4366,4446
10014040009,臺東縣,卑南鄉,泰安村,臺東縣第01選區,黃建賓,中國國民黨,145,97,187,recall_disagree_votes,-42,284,576,575
10017070009,基隆市,信義區,禮儀里,基隆市第01選區,林沛祥,中國國民黨,476,300,518,recall_disagree_votes,-42,818,1426,1464
10017050019,基隆市,中山區,西康里,基隆市第01選區,林沛祥,中國國民黨,371,312,414,recall_disagree_votes,-43,726,1426,1451
68000090009,桃園市,龍潭區,上林里,桃園市第05選區,呂玉玲,中國國民黨,1328,956,1371,recall_disagree_votes,-43,2327,4333,4276
10018010017,新竹市,東區,親仁里,新竹市第01選區,鄭正鈐,中國國民黨,586,381,629,recall_disagree_votes,-43,1010,1736,1783
68000090032,桃園市,龍潭區,祥和里,桃園市第05選區,呂玉玲,中國國民黨,481,328,524,recall_disagree_votes,-43,852,1658,1534
10014060002,臺東縣,池上鄉,慶豐村,臺東縣第01選區,黃建賓,中國國民黨,107,71,151,recall_disagree_votes,-44,222,485,533
68000090019,桃園市,龍潭區,三林里,桃園市第05選區,呂玉玲,中國國民黨,1092,582,1136,recall_disagree_votes,-44,1718,2964,2998
68000100017,桃園市,平鎮區,龍恩里,桃園市第05選區,呂玉玲,中國國民黨,1048,454,1093,recall_disagree_votes,-45,1547,2723,2740
65000040058,新北市,永和區,後溪里,新北市第09選區,林德福,中國國民黨,554,477,599,recall_disagree_votes,-45,1076,1874,1757
68000080024,桃園市,八德區,大信里,桃園市第06選區,邱若華,中國國民黨,990,593,1037,recall_disagree_votes,-47,1630,3115,3104
10017020002,基隆市,七堵區,正光里,基隆市第01選區,林沛祥,中國國民黨,678,529,725,recall_disagree_votes,-47,1254,2432,2456
10017070016,基隆市,信義區,東信里,基隆市第01選區,林沛祥,中國國民黨,1358,788,1405,recall_disagree_votes,-47,2193,3832,3905
10017070013,基隆市,信義區,東明里,基隆市第01選區,林沛祥,中國國民黨,1168,576,1215,recall_disagree_votes,-47,1791,3216,3315
10017040017,基隆市,仁愛區,德厚里,基隆市第01選區,林沛祥,中國國民黨,529,362,577,recall_disagree_votes,-48,939,1637,1631
65000030047,新北市,中和區,景平里,新北市第08選區,張智倫,中國國民黨,1931,1141,1980,recall_disagree_votes,-49,3121,5560,5192
68000080032,桃園市,八德區,大發里,桃園市第06選區,邱若華,中國國民黨,562,507,611,recall_disagree_votes,-49,1118,2011,1941
63000080029,臺北市,文山區,順興里,臺北市第08選區,賴士葆,中國國民黨,2046,1398,2096,recall_disagree_votes,-50,3494,5815,5927
65000030079,新北市,中和區,景本里,新北市第08選區,張智倫,中國國民黨,584,386,635,recall_disagree_votes,-51,1021,1731,1760
63000080036,臺北市,文山區,指南里,臺北市第08選區,賴士葆,中國國民黨,999,853,1050,recall_disagree_votes,-51,1903,3382,3380
10014090005,臺東縣,太麻里鄉,泰和村,臺東縣第01選區,黃建賓,中國國民黨,270,177,321,recall_disagree_votes,-51,498,949,979
65000030093,新北市,中和區,正行里,新北市第08選區,張智倫,中國國民黨,762,574,813,recall_disagree_votes,-51,1387,2414,2464
10018010011,新竹市,東區,育賢里,新竹市第01選區,鄭正鈐,中國國民黨,253,257,306,recall_disagree_votes,-53,563,1740,1659
65000030037,新北市,中和區,華南里,新北市第08選區,張智倫,中國國民黨,1590,801,1644,recall_disagree_votes,-54,2445,4305,4317
68000020018,桃園市,中壢區,忠義里,桃園市第03選區,魯明哲,中國國民黨,1280,814,1335,recall_disagree_votes,-55,2149,4039,3907
68000080021,桃園市,八德區,大忠里,桃園市第06選區,邱若華,中國國民黨,499,338,554,recall_disagree_votes,-55,892,1613,1641
10014080004,臺東縣,長濱鄉,長濱村,臺東縣第01選區,黃建賓,中國國民黨,228,136,284,recall_disagree_votes,-56,420,1033,1048
10009030016,雲林縣,虎尾鎮,西屯里,雲林縣第01選區,丁學忠,中國國民黨,386,300,442,recall_disagree_votes,-56,742,1387,1413
63000080034,臺北市,文山區,博嘉里,臺北市第08選區,賴士葆,中國國民黨,1583,1105,1639,recall_disagree_votes,-56,2744,4750,4808
10015050002,花蓮縣,吉安鄉,勝安村,花蓮縣第01選區,傅崐萁,中國國民黨,1594,1367,1651,recall_disagree_votes,-57,3018,4642,4674
68000100034,桃園市,平鎮區,廣仁里,桃園市第05選區,呂玉玲,中國國民黨,1209,856,1266,recall_disagree_votes,-57,2122,3963,3990
65000030040,新北市,中和區,景南里,新北市第08選區,張智倫,中國國民黨,920,511,978,recall_disagree_votes,-58,1489,2636,2667
10014020004,臺東縣,成功鎮,三民里,臺東縣第01選區,黃建賓,中國國民黨,299,122,357,recall_disagree_votes,-58,479,1091,1096
10004020021,新竹縣,竹東鎮,中正里,新竹縣第02選區,林思銘,中國國民黨,873,332,932,recall_disagree_votes,-59,1264,2542,2470
10017040024,基隆市,仁愛區,朝棟里,基隆市第01選區,林沛祥,中國國民黨,860,450,920,recall_disagree_votes,-60,1370,2521,2555
68000090013,桃園市,龍潭區,九龍里,桃園市第05選區,呂玉玲,中國國民黨,1199,635,1259,recall_disagree_votes,-60,1894,3608,3591
68000100035,桃園市,平鎮區,新貴里,桃園市第05選區,呂玉玲,中國國民黨,919,734,980,recall_disagree_votes,-61,1714,2898,2969
68000090029,桃園市,龍潭區,北興里,桃園市第05選區,呂玉玲,中國國民黨,717,341,778,recall_disagree_votes,-61,1119,2061,2054
65000030039,新北市,中和區,崇南里,新北市第08選區,張智倫,中國國民黨,1402,741,1463,recall_disagree_votes,-61,2204,3825,3804
68000100015,桃園市,平鎮區,山峰里,桃園市第05選區,呂玉玲,中國國民黨,724,387,785,recall_disagree_votes,-61,1172,2039,2057
10017070012,基隆市,信義區,東光里,基隆市第01選區,林沛祥,中國國民黨,537,384,599,recall_disagree_votes,-62,983,1774,1789
63000020027,臺北市,信義區,大仁里,臺北市第07選區,徐巧芯,中國國民黨,1771,1500,1833,recall_disagree_votes,-62,3333,6735,5972
10014110001,臺東縣,綠島鄉,公舘村,臺東縣第01選區,黃建賓,中國國民黨,204,82,266,recall_disagree_votes,-62,348,979,990
68000020010,桃園市,中壢區,中堅里,桃園市第06選區,邱若華,中國國民黨,1368,560,1430,recall_disagree_votes,-62,1990,3508,3605
65000030067,新北市,中和區,德穗里,新北市第08選區,張智倫,中國國民黨,1223,963,1286,recall_disagree_votes,-63,2249,3903,3937
68000080009,桃園市,八德區,竹園里,桃園市第06選區,邱若華,中國國民黨,958,714,1021,recall_disagree_votes,-63,1735,3372,3402
68000100003,桃園市,平鎮區,復旦里,桃園市第05選區,呂玉玲,中國國民黨,1692,1133,1755,recall_disagree_votes,-63,2888,5272,5267
68000080028,桃園市,八德區,瑞泰里,桃園市第06選區,邱若華,中國國民黨,1091,894,1155,recall_disagree_votes,-64,2049,3806,3793
68000090033,桃園市,龍潭區,渴望里,桃園市第05選區,呂玉玲,中國國民黨,871,436,936,recall_disagree_votes,-65,1372,2330,2197
68000100025,桃園市,平鎮區,東安里,桃園市第05選區,呂玉玲,中國國民黨,929,423,995,recall_disagree_votes,-66,1418,2551,2543
68000100010,桃園市,平鎮區,北興里,桃園市第05選區,呂玉玲,中國國民黨,1150,888,1216,recall_disagree_votes,-66,2104,3577,3658
65000030034,新北市,中和區,頂南里,新北市第08選區,張智倫,中國國民黨,936,448,1003,recall_disagree_votes,-67,1451,2390,2469
65000030014,新北市,中和區,福善里,新北市第08選區,張智倫,中國國民黨,1132,920,1199,recall_disagree_votes,-67,2119,3779,3729
63000080007,臺北市,文山區,萬有里,臺北市第08選區,賴士葆,中國國民黨,1561,1035,1628,recall_disagree_votes,-67,2663,4372,4472
68000090014,桃園市,龍潭區,中興里,桃園市第05選區,呂玉玲,中國國民黨,1372,683,1440,recall_disagree_votes,-68,2123,3955,3908
68000100038,桃園市,平鎮區,華安里,桃園市第05選區,呂玉玲,中國國民黨,1368,602,1436,recall_disagree_votes,-68,2038,3678,3696
68000020009,桃園市,中壢區,自強里,桃園市第06選區,邱若華,中國國民黨,1207,561,1276,recall_disagree_votes,-69,1837,3295,3276
10017030001,基隆市,暖暖區,八西里,基隆市第01選區,林沛祥,中國國民黨,324,272,394,recall_disagree_votes,-70,666,1281,1324
10017020005,基隆市,七堵區,永安里,基隆市第01選區,林沛祥,中國國民黨,621,430,691,recall_disagree_votes,-70,1121,1997,2030
65000030070,新北市,中和區,壽德里,新北市第08選區,張智倫,中國國民黨,1531,745,1601,recall_disagree_votes,-70,2346,3798,3790
63000080001,臺北市,文山區,景行里,臺北市第08選區,賴士葆,中國國民黨,1822,1564,1894,recall_disagree_votes,-72,3458,6102,6126
68000090030,桃園市,龍潭區,建林里,桃園市第05選區,呂玉玲,中國國民黨,1466,553,1538,recall_disagree_votes,-72,2091,3427,3477
68000020061,桃園市,中壢區,普強里,桃園市第03選區,魯明哲,中國國民黨,1243,708,1315,recall_disagree_votes,-72,2023,3476,3496
68000090020,桃園市,龍潭區,永興里,桃園市第05選區,呂玉玲,中國國民黨,771,554,844,recall_disagree_votes,-73,1398,2569,2575
63000080016,臺北市,文山區,興得里,臺北市第08選區,賴士葆,中國國民黨,1782,1116,1855,recall_disagree_votes,-73,2971,5011,5031
10014050004,臺東縣,鹿野鄉,永安村,臺東縣第01選區,黃建賓,中國國民黨,165,163,240,recall_disagree_votes,-75,403,893,930
68000100001,桃園市,平鎮區,雙連里,桃園市第05選區,呂玉玲,中國國民黨,1339,927,1414,recall_disagree_votes,-75,2341,4379,4474
10018010002,新竹市,東區,福德里,新竹市第01選區,鄭正鈐,中國國民黨,393,402,468,recall_disagree_votes,-75,870,1399,1399
68000020052,桃園市,中壢區,振興里,桃園市第03選區,魯明哲,中國國民黨,1666,979,1742,recall_disagree_votes,-76,2721,4517,4560
63000080004,臺北市,文山區,景慶里,臺北市第08選區,賴士葆,中國國民黨,1686,1232,1762,recall_disagree_votes,-76,2994,5069,5123
68000030028,桃園市,大溪區,仁美里,桃園市第06選區,邱若華,中國國民黨,1007,703,1085,recall_disagree_votes,-78,1788,3104,3094
10014110003,臺東縣,綠島鄉,南寮村,臺東縣第01選區,黃建賓,中國國民黨,334,153,413,recall_disagree_votes,-79,566,1570,1601
68000030024,桃園市,大溪區,三元里,桃園市第06選區,邱若華,中國國民黨,994,386,1073,recall_disagree_votes,-79,1459,2666,2733
68000030026,桃園市,大溪區,仁文里,桃園市第06選區,邱若華,中國國民黨,1045,775,1125,recall_disagree_votes,-80,1900,3566,3523
65000030043,新北市,中和區,壽南里,新北市第08選區,張智倫,中國國民黨,703,554,783,recall_disagree_votes,-80,1337,2388,2206
10018030017,新竹市,香山區,茄苳里,新竹市第01選區,鄭正鈐,中國國民黨,229,189,309,recall_disagree_votes,-80,498,1008,948
68000090012,桃園市,龍潭區,高原里,桃園市第05選區,呂玉玲,中國國民黨,1184,854,1267,recall_disagree_votes,-83,2121,4090,4006
10017020009,基隆市,七堵區,泰安里,基隆市第01選區,林沛祥,中國國民黨,1112,1056,1196,recall_disagree_votes,-84,2252,4292,4123
65000030019,新北市,中和區,佳和里,新北市第08選區,張智倫,中國國民黨,1316,1028,1400,recall_disagree_votes,-84,2428,4310,4281
68000020056,桃園市,中壢區,復華里,桃園市第03選區,魯明哲,中國國民黨,1843,1126,1927,recall_disagree_votes,-84,3053,5345,5313
10017010026,基隆市,中正區,新富里,基隆市第01選區,林沛祥,中國國民黨,1167,770,1252,recall_disagree_votes,-85,2022,4225,4275
65000030045,新北市,中和區,復興里,新北市第08選區,張智倫,中國國民黨,1381,942,1467,recall_disagree_votes,-86,2409,4199,4238
68000080030,桃園市,八德區,大正里,桃園市第06選區,邱若華,中國國民黨,1253,993,1339,recall_disagree_votes,-86,2332,4280,4249
68000090021,桃園市,龍潭區,烏樹林里,桃園市第05選區,呂玉玲,中國國民黨,730,557,817,recall_disagree_votes,-87,1374,2573,2516
10018010032,新竹市,東區,仙宮里,新竹市第01選區,鄭正鈐,中國國民黨,337,313,424,recall_disagree_votes,-87,737,1164,1191
68000030027,桃園市,大溪區,仁和里,桃園市第06選區,邱若華,中國國民黨,1374,1050,1463,recall_disagree_votes,-89,2513,4572,4488
10017050024,基隆市,中山區,和慶里,基隆市第01選區,林沛祥,中國國民黨,1629,1203,1720,recall_disagree_votes,-91,2923,6192,6193
68000020016,桃園市,中壢區,普仁里,桃園市第03選區,魯明哲,中國國民黨,1244,794,1335,recall_disagree_votes,-91,2129,4254,4116
65000030025,新北市,中和區,新南里,新北市第08選區,張智倫,中國國民黨,2380,1527,2471,recall_disagree_votes,-91,3998,7000,6954
68000100039,桃園市,平鎮區,金陵里,桃園市第05選區,呂玉玲,中國國民黨,874,647,966,recall_disagree_votes,-92,1613,2723,2754
10018010033,新竹市,東區,光明里,新竹市第01選區,鄭正鈐,中國國民黨,903,565,996,recall_disagree_votes,-93,1561,2709,2780
68000100023,桃園市,平鎮區,建安里,桃園市第05選區,呂玉玲,中國國民黨,1285,958,1379,recall_disagree_votes,-94,2337,4133,4084
68000020081,桃園市,中壢區,中興里,桃園市第03選區,魯明哲,中國國民黨,1207,606,1302,recall_disagree_votes,-95,1908,3342,3254
68000030020,桃園市,大溪區,員林里,桃園市第06選區,邱若華,中國國民黨,422,338,517,recall_disagree_votes,-95,855,1698,1545
65000030026,新北市,中和區,南山里,新北市第08選區,張智倫,中國國民黨,1502,1041,1597,recall_disagree_votes,-95,2638,4444,4446
68000100007,桃園市,平鎮區,新勢里,桃園市第05選區,呂玉玲,中國國民黨,1099,868,1195,recall_disagree_votes,-96,2063,3520,3505
68000090025,桃園市,龍潭區,龍星里,桃園市第05選區,呂玉玲,中國國民黨,1388,858,1485,recall_disagree_votes,-97,2343,3981,4033
65000030051,新北市,中和區,景文里,新北市第08選區,張智倫,中國國民黨,1176,823,1273,recall_disagree_votes,-97,2096,3557,3496
63000080020,臺北市,文山區,興旺里,臺北市第08選區,賴士葆,中國國民黨,2511,1314,2611,recall_disagree_votes,-100,3925,6635,6723
68000100006,桃園市,平鎮區,宋屋里,桃園市第05選區,呂玉玲,中國國民黨,1282,912,1382,recall_disagree_votes,-100,2294,4073,4074
65000030050,新北市,中和區,景安里,新北市第08選區,張智倫,中國國民黨,1501,957,1603,recall_disagree_votes,-102,2560,4191,4204
68000100004,桃園市,平鎮區,廣興里,桃園市第05選區,呂玉玲,中國國民黨,1596,1297,1698,recall_disagree_votes,-102,2995,5334,5292
68000090015,桃園市,龍潭區,佳安里,桃園市第05選區,呂玉玲,中國國民黨,1219,577,1321,recall_disagree_votes,-102,1898,3306,3379
68000080023,桃園市,八德區,大勇里,桃園市第06選區,邱若華,中國國民黨,1128,1031,1231,recall_disagree_votes,-103,2262,4020,3956
68000100021,桃園市,平鎮區,忠貞里,桃園市第05選區,呂玉玲,中國國民黨,553,219,656,recall_disagree_votes,-103,875,1462,1427
65000030046,新北市,中和區,和興里,新北市第08選區,張智倫,中國國民黨,1248,872,1351,recall_disagree_votes,-103,2223,3855,3779
63000050007,臺北市,中正區,網溪里,臺北市第08選區,賴士葆,中國國民黨,1422,1187,1526,recall_disagree_votes,-104,2713,4691,4675
10017070020,基隆市,信義區,孝忠里,基隆市第01選區,林沛祥,中國國民黨,2324,1430,2428,recall_disagree_votes,-104,3858,7245,7275
10018010036,新竹市,東區,軍功里,新竹市第01選區,鄭正鈐,中國國民黨,890,478,994,recall_disagree_votes,-104,1472,2579,2592
68000020071,桃園市,中壢區,華勛里,桃園市第06選區,邱若華,中國國民黨,1434,473,1539,recall_disagree_votes,-105,2012,3693,3709
68000020002,桃園市,中壢區,龍昌里,桃園市第03選區,魯明哲,中國國民黨,2185,958,2290,recall_disagree_votes,-105,3248,5864,5754
68000090003,桃園市,龍潭區,烏林里,桃園市第05選區,呂玉玲,中國國民黨,1387,824,1492,recall_disagree_votes,-105,2316,4502,4460
10014020006,臺東縣,成功鎮,忠仁里,臺東縣第01選區,黃建賓,中國國民黨,384,211,490,recall_disagree_votes,-106,701,1515,1543
68000090026,桃園市,龍潭區,上華里,桃園市第05選區,呂玉玲,中國國民黨,1089,502,1195,recall_disagree_votes,-106,1697,3094,3071
68000100029,桃園市,平鎮區,湧豐里,桃園市第05選區,呂玉玲,中國國民黨,506,394,613,recall_disagree_votes,-107,1007,1794,1668
63000080032,臺北市,文山區,樟腳里,臺北市第08選區,賴士葆,中國國民黨,1485,994,1594,recall_disagree_votes,-109,2588,4322,4471
68000100041,桃園市,平鎮區,北華里,桃園市第05選區,呂玉玲,中國國民黨,1205,854,1315,recall_disagree_votes,-110,2169,3662,3705
65000030006,新北市,中和區,建和里,新北市第08選區,張智倫,中國國民黨,1049,652,1161,recall_disagree_votes,-112,1813,3088,3017
10018020017,新竹市,北區,光田里,新竹市第01選區,鄭正鈐,中國國民黨,563,488,677,recall_disagree_votes,-114,1165,1953,1968
65000030052,新北市,中和區,錦和里,新北市第08選區,張智倫,中國國民黨,1363,1096,1477,recall_disagree_votes,-114,2573,4533,4557
68000080022,桃園市,八德區,大福里,桃園市第06選區,邱若華,中國國民黨,1615,1166,1731,recall_disagree_votes,-116,2897,4949,5011
68000020003,桃園市,中壢區,仁德里,桃園市第06選區,邱若華,中國國民黨,1027,473,1144,recall_disagree_votes,-117,1617,2886,2907
68000100011,桃園市,平鎮區,北貴里,桃園市第05選區,呂玉玲,中國國民黨,1177,942,1296,recall_disagree_votes,-119,2238,3853,3834
68000100016,桃園市,平鎮區,湧光里,桃園市第05選區,呂玉玲,中國國民黨,1494,1054,1614,recall_disagree_votes,-120,2668,4688,4791
68000020042,桃園市,中壢區,後寮里,桃園市第03選區,魯明哲,中國國民黨,1564,954,1689,recall_disagree_votes,-125,2643,5083,4823
68000090022,桃園市,龍潭區,百年里,桃園市第05選區,呂玉玲,中國國民黨,1741,695,1866,recall_disagree_votes,-125,2561,4256,4168
68000020082,桃園市,中壢區,龍慈里,桃園市第03選區,魯明哲,中國國民黨,1739,815,1864,recall_disagree_votes,-125,2679,4727,4620
68000100043,桃園市,平鎮區,平興里,桃園市第05選區,呂玉玲,中國國民黨,1683,1196,1809,recall_disagree_votes,-126,3005,5354,5285
68000080025,桃園市,八德區,大華里,桃園市第06選區,邱若華,中國國民黨,686,525,819,recall_disagree_votes,-133,1344,2318,2307
68000090006,桃園市,龍潭區,凌雲里,桃園市第05選區,呂玉玲,中國國民黨,1102,681,1235,recall_disagree_votes,-133,1916,3615,3555
68000020019,桃園市,中壢區,中正里,桃園市第06選區,邱若華,中國國民黨,1661,858,1797,recall_disagree_votes,-136,2655,4931,4902
68000100044,桃園市,平鎮區,新英里,桃園市第05選區,呂玉玲,中國國民黨,1182,793,1319,recall_disagree_votes,-137,2112,3796,3687
68000020020,桃園市,中壢區,興仁里,桃園市第06選區,邱若華,中國國民黨,1029,591,1167,recall_disagree_votes,-138,1758,3359,3256
65000030080,新北市,中和區,福南里,新北市第08選區,張智倫,中國國民黨,1325,674,1463,recall_disagree_votes,-138,2137,3578,3599
10018020023,新竹市,北區,武陵里,新竹市第01選區,鄭正鈐,中國國民黨,1939,599,2078,recall_disagree_votes,-139,2677,4265,4312
68000090023,桃園市,龍潭區,龍祥里,桃園市第05選區,呂玉玲,中國國民黨,1039,600,1179,recall_disagree_votes,-140,1779,3256,3274
10014020005,臺東縣,成功鎮,忠智里,臺東縣第01選區,黃建賓,中國國民黨,390,173,531,recall_disagree_votes,-141,704,1456,1511
10018010051,新竹市,東區,錦華里,新竹市第01選區,鄭正鈐,中國國民黨,498,474,640,recall_disagree_votes,-142,1114,1838,1836
68000100032,桃園市,平鎮區,福林里,桃園市第05選區,呂玉玲,中國國民黨,960,815,1103,recall_disagree_votes,-143,1918,3257,3304
68000080008,桃園市,八德區,廣隆里,桃園市第06選區,邱若華,中國國民黨,1371,1004,1518,recall_disagree_votes,-147,2522,4384,4344
10014060005,臺東縣,池上鄉,福原村,臺東縣第01選區,黃建賓,中國國民黨,351,302,500,recall_disagree_votes,-149,802,1612,1633
68000100026,桃園市,平鎮區,新安里,桃園市第05選區,呂玉玲,中國國民黨,1291,767,1443,recall_disagree_votes,-152,2210,3938,3932
10018030016,新竹市,香山區,海山里,新竹市第01選區,鄭正鈐,中國國民黨,612,514,767,recall_disagree_votes,-155,1281,2178,2177
10018010025,新竹市,東區,武功里,新竹市第01選區,鄭正鈐,中國國民黨,1629,561,1785,recall_disagree_votes,-156,2346,3827,3781
68000090007,桃園市,龍潭區,八德里,桃園市第05選區,呂玉玲,中國國民黨,1238,873,1394,recall_disagree_votes,-156,2267,4201,4040
10018030020,新竹市,香山區,中隘里,新竹市第01選區,鄭正鈐,中國國民黨,499,362,660,recall_disagree_votes,-161,1022,1930,1816
10018010048,新竹市,東區,建華里,新竹市第01選區,鄭正鈐,中國國民黨,603,567,764,recall_disagree_votes,-161,1331,2161,2280
68000080020,桃園市,八德區,大義里,桃園市第06選區,邱若華,中國國民黨,1049,727,1211,recall_disagree_votes,-162,1938,3548,3539
10017070017,基隆市,信義區,孝深里,基隆市第01選區,林沛祥,中國國民黨,1503,869,1668,recall_disagree_votes,-165,2537,5035,4848
65000030084,新北市,中和區,碧河里,新北市第08選區,張智倫,中國國民黨,1342,1159,1508,recall_disagree_votes,-166,2667,4536,4485
10017010022,基隆市,中正區,砂子里,基隆市第01選區,林沛祥,中國國民黨,1315,1137,1483,recall_disagree_votes,-168,2620,5638,5010
10018010027,新竹市,東區,東山里,新竹市第01選區,鄭正鈐,中國國民黨,908,656,1078,recall_disagree_votes,-170,1734,2848,2902
65000030008,新北市,中和區,連城里,新北市第08選區,張智倫,中國國民黨,1842,1265,2017,recall_disagree_votes,-175,3282,5466,5548
68000100005,桃園市,平鎮區,義民里,桃園市第05選區,呂玉玲,中國國民黨,1492,1082,1671,recall_disagree_votes,-179,2753,5050,5056
65000030055,新北市,中和區,積穗里,新北市第08選區,張智倫,中國國民黨,2143,1728,2323,recall_disagree_votes,-180,4051,7021,7051
68000080049,桃園市,八德區,福元里,桃園市第06選區,邱若華,中國國民黨,1088,851,1269,recall_disagree_votes,-181,2120,4043,4066
10018020019,新竹市,北區,福林里,新竹市第01選區,鄭正鈐,中國國民黨,1138,904,1320,recall_disagree_votes,-182,2224,3641,3686
68000020075,桃園市,中壢區,仁和里,桃園市第06選區,邱若華,中國國民黨,1149,586,1334,recall_disagree_votes,-185,1920,3311,3292
10018010040,新竹市,東區,千甲里,新竹市第01選區,鄭正鈐,中國國民黨,570,440,756,recall_disagree_votes,-186,1196,1897,1960
10018010013,新竹市,東區,公園里,新竹市第01選區,鄭正鈐,中國國民黨,925,703,1113,recall_disagree_votes,-188,1816,3055,3103
68000100014,桃園市,平鎮區,莊敬里,桃園市第05選區,呂玉玲,中國國民黨,1546,878,1734,recall_disagree_votes,-188,2612,4589,4608
10014040010,臺東縣,卑南鄉,太平村,臺東縣第01選區,黃建賓,中國國民黨,583,405,771,recall_disagree_votes,-188,1176,2187,2264
65000030073,新北市,中和區,德行里,新北市第08選區,張智倫,中國國民黨,1749,1386,1938,recall_disagree_votes,-189,3324,5562,5569
10018020015,新竹市,北區,水田里,新竹市第01選區,鄭正鈐,中國國民黨,812,890,1006,recall_disagree_votes,-194,1896,3189,3145
68000100013,桃園市,平鎮區,南勢里,桃園市第05選區,呂玉玲,中國國民黨,1629,1295,1823,recall_disagree_votes,-194,3118,5577,5552
68000090018,桃園市,龍潭區,大平里,桃園市第05選區,呂玉玲,中國國民黨,785,659,981,recall_disagree_votes,-196,1640,3180,2611
10017070019,基隆市,信義區,孝德里,基隆市第01選區,林沛祥,中國國民黨,788,518,986,recall_disagree_votes,-198,1504,2850,2625
68000020068,桃園市,中壢區,中山里,桃園市第06選區,邱若華,中國國民黨,1518,800,1716,recall_disagree_votes,-198,2516,4543,4467
68000030017,桃園市,大溪區,仁善里,桃園市第06選區,邱若華,中國國民黨,1259,1035,1460,recall_disagree_votes,-201,2495,4690,4447
10018020021,新竹市,北區,湳雅里,新竹市第01選區,鄭正鈐,中國國民黨,736,714,938,recall_disagree_votes,-202,1652,2583,2644
65000030049,新北市,中和區,景福里,新北市第08選區,張智倫,中國國民黨,1722,1180,1925,recall_disagree_votes,-203,3105,5567,5159
10018020039,新竹市,北區,光華里,新竹市第01選區,鄭正鈐,中國國民黨,932,817,1136,recall_disagree_votes,-204,1953,4055,4059
65000030009,新北市,中和區,力行里,新北市第08選區,張智倫,中國國民黨,1569,1343,1779,recall_disagree_votes,-210,3122,5222,5204
10018030021,新竹市,香山區,內湖里,新竹市第01選區,鄭正鈐,中國國民黨,1028,917,1245,recall_disagree_votes,-217,2162,4097,4109
10017030006,基隆市,暖暖區,碇和里,基隆市第01選區,林沛祥,中國國民黨,818,528,1035,recall_disagree_votes,-217,1563,2926,2921
68000070010,桃園市,龜山區,樂善里,桃園市第01選區,牛煦庭,中國國民黨,4210,3489,4428,recall_disagree_votes,-218,7917,15882,11411
68000090010,桃園市,龍潭區,中正里,桃園市第05選區,呂玉玲,中國國民黨,1849,1014,2067,recall_disagree_votes,-218,3081,5479,5390
68000090001,桃園市,龍潭區,黃唐里,桃園市第05選區,呂玉玲,中國國民黨,1358,923,1577,recall_disagree_votes,-219,2500,4525,4453
68000080038,桃園市,八德區,茄明里,桃園市第06選區,邱若華,中國國民黨,1244,1014,1464,recall_disagree_votes,-220,2478,4862,4740
65000030081,新北市,中和區,中興里,新北市第08選區,張智倫,中國國民黨,1782,1236,2004,recall_disagree_votes,-222,3240,5563,5647
10018020016,新竹市,北區,文雅里,新竹市第01選區,鄭正鈐,中國國民黨,1020,1099,1248,recall_disagree_votes,-228,2347,3826,3870
10018010046,新竹市,東區,關東里,新竹市第01選區,鄭正鈐,中國國民黨,1389,1000,1618,recall_disagree_votes,-229,2618,4620,4702
68000080042,桃園市,八德區,大宏里,桃園市第06選區,邱若華,中國國民黨,1434,1105,1666,recall_disagree_votes,-232,2771,4789,4736
10018010019,新竹市,東區,復中里,新竹市第01選區,鄭正鈐,中國國民黨,1101,1068,1334,recall_disagree_votes,-233,2402,3976,3939
65000030001,新北市,中和區,中原里,新北市第08選區,張智倫,中國國民黨,2320,2009,2554,recall_disagree_votes,-234,4563,8448,8000
10018020045,新竹市,北區,中雅里,新竹市第01選區,鄭正鈐,中國國民黨,1128,676,1364,recall_disagree_votes,-236,2040,3240,3272
10018010028,新竹市,東區,光鎮里,新竹市第01選區,鄭正鈐,中國國民黨,865,845,1102,recall_disagree_votes,-237,1947,3351,3419
68000080039,桃園市,八德區,高城里,桃園市第06選區,邱若華,中國國民黨,816,641,1055,recall_disagree_votes,-239,1696,3019,2999
66000080007,臺中市,北屯區,舊社里,臺中市第05選區,黃健豪,中國國民黨,4463,3774,4704,recall_disagree_votes,-241,8478,16281,12117
10018010052,新竹市,東區,湖濱里,新竹市第01選區,鄭正鈐,中國國民黨,908,902,1149,recall_disagree_votes,-241,2051,3300,3368
68000090002,桃園市,龍潭區,中山里,桃園市第05選區,呂玉玲,中國國民黨,1929,1287,2172,recall_disagree_votes,-243,3459,6471,6323
10018010024,新竹市,東區,豐功里,新竹市第01選區,鄭正鈐,中國國民黨,1332,1013,1577,recall_disagree_votes,-245,2590,4249,4293
10018030011,新竹市,香山區,香村里,新竹市第01選區,鄭正鈐,中國國民黨,991,843,1238,recall_disagree_votes,-247,2081,3740,3609
65000030007,新北市,中和區,連和里,新北市第08選區,張智倫,中國國民黨,759,498,1006,recall_disagree_votes,-247,1504,2634,2187
68000100008,桃園市,平鎮區,新富里,桃園市第05選區,呂玉玲,中國國民黨,1632,1321,1881,recall_disagree_votes,-249,3202,6781,6477
10018010037,新竹市,東區,建功里,新竹市第01選區,鄭正鈐,中國國民黨,1427,612,1684,recall_disagree_votes,-257,2296,3727,3707
68000080043,桃園市,八德區,大漢里,桃園市第06選區,邱若華,中國國民黨,1064,751,1323,recall_disagree_votes,-259,2074,3759,3696
68000100030,桃園市,平鎮區,湧安里,桃園市第05選區,呂玉玲,中國國民黨,1257,848,1526,recall_disagree_votes,-269,2374,4282,4309
66000070006,臺中市,南屯區,春安里,臺中市第04選區,廖偉翔,中國國民黨,974,764,1252,recall_disagree_votes,-278,2016,4064,2375
68000080027,桃園市,八德區,大智里,桃園市第06選區,邱若華,中國國民黨,1315,762,1596,recall_disagree_votes,-281,2358,4118,4166
10018010018,新竹市,東區,文華里,新竹市第01選區,鄭正鈐,中國國民黨,1207,1102,1503,recall_disagree_votes,-296,2605,4392,4370
10018020036,新竹市,北區,境福里,新竹市第01選區,鄭正鈐,中國國民黨,1187,1171,1484,recall_disagree_votes,-297,2655,4405,4395
68000080051,桃園市,八德區,興中里,桃園市第06選區,邱若華,中國國民黨,1045,877,1344,recall_disagree_votes,-299,2221,4633,4075
10018020032,新竹市,北區,曲溪里,新竹市第01選區,鄭正鈐,中國國民黨,1346,1102,1653,recall_disagree_votes,-307,2755,4977,5004
68000080046,桃園市,八德區,陸光里,桃園市第06選區,邱若華,中國國民黨,1515,444,1830,recall_disagree_votes,-315,2274,4169,4134
10018020040,新竹市,北區,金華里,新竹市第01選區,鄭正鈐,中國國民黨,1236,1229,1565,recall_disagree_votes,-329,2794,4657,4663
65000030002,新北市,中和區,平河里,新北市第08選區,張智倫,中國國民黨,2329,1934,2667,recall_disagree_votes,-338,4601,7982,7760
10018010026,新竹市,東區,綠水里,新竹市第01選區,鄭正鈐,中國國民黨,1708,1418,2059,recall_disagree_votes,-351,3477,5915,6015
10018010053,新竹市,東區,明湖里,新竹市第01選區,鄭正鈐,中國國民黨,1236,930,1588,recall_disagree_votes,-352,2518,4881,4791
68000100033,桃園市,平鎮區,金星里,桃園市第05選區,呂玉玲,中國國民黨,1915,1307,2267,recall_disagree_votes,-352,3574,6759,6497
10018030010,新竹市,香山區,東香里,新竹市第01選區,鄭正鈐,中國國民黨,1100,956,1458,recall_disagree_votes,-358,2414,4107,4009
10018010031,新竹市,東區,高峰里,新竹市第01選區,鄭正鈐,中國國民黨,1496,1321,1856,recall_disagree_votes,-360,3177,5376,5471
10018010016,新竹市,東區,振興里,新竹市第01選區,鄭正鈐,中國國民黨,1398,1262,1759,recall_disagree_votes,-361,3021,5251,5296
68000100045,桃園市,平鎮區,平安里,桃園市第05選區,呂玉玲,中國國民黨,1496,1220,1858,recall_disagree_votes,-362,3078,5465,5084
10018010045,新竹市,東區,金山里,新竹市第01選區,鄭正鈐,中國國民黨,1446,1062,1810,recall_disagree_votes,-364,2872,5096,5128
10017010025,基隆市,中正區,新豐里,基隆市第01選區,林沛祥,中國國民黨,1800,1270,2165,recall_disagree_votes,-365,3435,6686,6104
10017050020,基隆市,中山區,德和里,基隆市第01選區,林沛祥,中國國民黨,2008,1411,2376,recall_disagree_votes,-368,3787,6899,5855
10018020022,新竹市,北區,舊社里,新竹市第01選區,鄭正鈐,中國國民黨,1546,1484,1917,recall_disagree_votes,-371,3401,5629,5747
65000060052,新北市,新店區,中山里,新北市第11選區,羅明才,中國國民黨,2911,1524,3286,recall_disagree_votes,-375,4810,9195,6084
10018020028,新竹市,北區,中寮里,新竹市第01選區,鄭正鈐,中國國民黨,873,938,1261,recall_disagree_votes,-388,2199,3908,3793
68000100046,桃園市,平鎮區,平南里,桃園市第05選區,呂玉玲,中國國民黨,1958,1423,2357,recall_disagree_votes,-399,3780,6616,6662
10018030024,新竹市,香山區,頂福里,新竹市第01選區,鄭正鈐,中國國民黨,1081,1153,1487,recall_disagree_votes,-406,2640,4506,4337
10018010050,新竹市,東區,復興里,新竹市第01選區,鄭正鈐,中國國民黨,1223,1163,1629,recall_disagree_votes,-406,2792,4827,4783
10018010047,新竹市,東區,科園里,新竹市第01選區,鄭正鈐,中國國民黨,1863,1374,2281,recall_disagree_votes,-418,3655,5755,5938
10018030008,新竹市,香山區,牛埔里,新竹市第01選區,鄭正鈐,中國國民黨,1097,1160,1535,recall_disagree_votes,-438,2695,4975,4688
10018010043,新竹市,東區,新莊里,新竹市第01選區,鄭正鈐,中國國民黨,1359,1154,1810,recall_disagree_votes,-451,2964,4955,5014
10018020041,新竹市,北區,金竹里,新竹市第01選區,鄭正鈐,中國國民黨,1543,1373,2017,recall_disagree_votes,-474,3390,5600,5635
10018010030,新竹市,東區,柴橋里,新竹市第01選區,鄭正鈐,中國國民黨,1384,1311,1859,recall_disagree_votes,-475,3170,5342,5189
68000080017,桃園市,八德區,大和里,桃園市第06選區,邱若華,中國國民黨,2151,1370,2636,recall_disagree_votes,-485,4006,7398,7149
10017030013,基隆市,暖暖區,碇祥里,基隆市第01選區,林沛祥,中國國民黨,1392,1069,1910,recall_disagree_votes,-518,2979,5873,5733
10018010021,新竹市,東區,東園里,新竹市第01選區,鄭正鈐,中國國民黨,1353,1579,1918,recall_disagree_votes,-565,3497,5687,5678
10018020042,新竹市,北區,湳中里,新竹市第01選區,鄭正鈐,中國國民黨,1851,1664,2430,recall_disagree_votes,-579,4094,6695,6565
10018010044,新竹市,東區,仙水里,新竹市第01選區,鄭正鈐,中國國民黨,1147,1256,1726,recall_disagree_votes,-579,2982,5058,4241
10018010042,新竹市,東區,龍山里,新竹市第01選區,鄭正鈐,中國國民黨,2108,2374,3044,recall_disagree_votes,-936,5418,9261,9351
