VILLCODE,COUNTYNAME,TOWNNAME,VILLNAME,election_zone,winner_name,winner_party,winner_votes,recall_agree_votes,recall_disagree_votes,compared_with,gap,recall_valid_votes,recall_eligible_voters,eligible_voters_election
66000070007,臺中市,南屯區,文山里,臺中市第04選區,張廖萬堅,民主進步黨,3981,2854,3472,recall_agree_votes,1127,6326,11500,11125
68000020027,桃園市,中壢區,內定里,桃園市第03選區,彭俊豪,民主進步黨,2769,1738,1936,recall_agree_votes,1031,3674,6612,6762
68000020043,桃園市,中壢區,過嶺里,桃園市第03選區,彭俊豪,民主進步黨,3131,2126,2896,recall_agree_votes,1005,5022,9484,8426
66000070002,臺中市,南屯區,豐樂里,臺中市第04選區,張廖萬堅,民主進步黨,4168,3212,3593,recall_agree_votes,956,6805,11609,11275
68000060002,桃園市,大園區,田心里,桃園市第02選區,黃世杰,民主進步黨,2644,1749,2018,recall_agree_votes,895,3767,7134,7060
68000020044,桃園市,中壢區,五權里,桃園市第03選區,彭俊豪,民主進步黨,2269,1476,2028,recall_agree_votes,793,3504,6114,6154
68000020047,桃園市,中壢區,月眉里,桃園市第03選區,彭俊豪,民主進步黨,2500,1745,1464,recall_agree_votes,755,3209,5863,5704
66000060002,臺中市,西屯區,西墩里,臺中市第04選區,張廖萬堅,民主進步黨,2347,1615,1831,recall_agree_votes,732,3446,6168,6009
68000120024,桃園市,觀音區,草新里,桃園市第02選區,黃世杰,民主進步黨,2095,1367,1826,recall_agree_votes,728,3193,6329,5931
66000070001,臺中市,南屯區,南屯里,臺中市第04選區,張廖萬堅,民主進步黨,2963,2254,2613,recall_agree_votes,709,4867,8266,8245
68000060011,桃園市,大園區,菓林里,桃園市第02選區,黃世杰,民主進步黨,2264,1562,1804,recall_agree_votes,702,3366,6306,6368
68000060001,桃園市,大園區,大園里,桃園市第02選區,黃世杰,民主進步黨,2203,1517,1687,recall_agree_votes,686,3204,5889,6110
63000100022,臺北市,內湖區,五分里,臺北市第04選區,高嘉瑜,民主進步黨,2656,1996,2446,recall_agree_votes,660,4442,7970,8226
65000270015,新北市,金山區,金美里,新北市第12選區,賴品妤,民主進步黨,1717,1084,1221,recall_agree_votes,633,2305,4761,4812
68000020073,桃園市,中壢區,幸福里,桃園市第03選區,彭俊豪,民主進步黨,1949,1319,1938,recall_agree_votes,630,3257,5947,5901
68000110002,桃園市,新屋區,新生里,桃園市第02選區,黃世杰,民主進步黨,1538,920,1362,recall_agree_votes,618,2282,3949,3928
68000120014,桃園市,觀音區,崙坪里,桃園市第02選區,黃世杰,民主進步黨,1917,1328,1175,recall_agree_votes,589,2503,4491,4583
66000060001,臺中市,西屯區,西安里,臺中市第04選區,張廖萬堅,民主進步黨,2013,1436,1690,recall_agree_votes,577,3126,5530,5335
68000060006,桃園市,大園區,五權里,桃園市第02選區,黃世杰,民主進步黨,2115,1539,1322,recall_agree_votes,576,2861,5196,5038
65000270005,新北市,金山區,美田里,新北市第12選區,賴品妤,民主進步黨,1363,790,937,recall_agree_votes,573,1727,3622,3708
66000060033,臺中市,西屯區,福和里,臺中市第04選區,張廖萬堅,民主進步黨,1732,1160,1117,recall_agree_votes,572,2277,4087,4171
68000060007,桃園市,大園區,埔心里,桃園市第02選區,黃世杰,民主進步黨,1695,1126,1226,recall_agree_votes,569,2352,4267,4430
68000020037,桃園市,中壢區,信義里,桃園市第03選區,彭俊豪,民主進步黨,1558,990,1480,recall_agree_votes,568,2470,4244,4214
66000060021,臺中市,西屯區,何仁里,臺中市第04選區,張廖萬堅,民主進步黨,2129,1564,1777,recall_agree_votes,565,3341,5911,5910
66000040015,臺中市,西區,昇平里,臺中市第06選區,江肇國,民主進步黨,2024,1459,1577,recall_agree_votes,565,3036,5414,5430
66000070023,臺中市,南屯區,寶山里,臺中市第04選區,張廖萬堅,民主進步黨,1849,1289,1544,recall_agree_votes,560,2833,5092,5111
68000020051,桃園市,中壢區,內厝里,桃園市第03選區,彭俊豪,民主進步黨,1860,1301,1322,recall_agree_votes,559,2623,4640,4669
68000020074,桃園市,中壢區,永福里,桃園市第03選區,彭俊豪,民主進步黨,1882,1329,1781,recall_agree_votes,553,3110,5290,5293
65000280001,新北市,萬里區,萬里里,新北市第12選區,賴品妤,民主進步黨,1468,916,1026,recall_agree_votes,552,1942,3934,4080
68000110004,桃園市,新屋區,清華里,桃園市第02選區,黃世杰,民主進步黨,1460,911,1388,recall_agree_votes,549,2299,4034,3969
68000020055,桃園市,中壢區,永光里,桃園市第03選區,彭俊豪,民主進步黨,1779,1232,1646,recall_agree_votes,547,2878,5388,5332
68000020049,桃園市,中壢區,山東里,桃園市第03選區,彭俊豪,民主進步黨,1674,1134,954,recall_agree_votes,540,2088,3836,3716
68000060019,桃園市,大園區,南港里,桃園市第02選區,黃世杰,民主進步黨,2106,1567,2153,recall_agree_votes,539,3720,7872,6476
66000040017,臺中市,西區,公正里,臺中市第06選區,江肇國,民主進步黨,2223,1688,1904,recall_agree_votes,535,3592,6050,6150
63000030004,臺北市,大安區,民炤里,臺北市第06選區,苗博雅,社會民主黨,2223,1689,1863,recall_agree_votes,534,3552,6258,6415
68000020062,桃園市,中壢區,明德里,桃園市第03選區,彭俊豪,民主進步黨,1579,1053,1547,recall_agree_votes,526,2600,4468,4475
66000060020,臺中市,西屯區,協和里,臺中市第04選區,張廖萬堅,民主進步黨,1677,1153,1318,recall_agree_votes,524,2471,4430,4474
68000020066,桃園市,中壢區,正義里,桃園市第03選區,彭俊豪,民主進步黨,1427,914,1389,recall_agree_votes,513,2303,4043,4114
68000110005,桃園市,新屋區,頭洲里,桃園市第02選區,黃世杰,民主進步黨,1676,1175,1533,recall_agree_votes,501,2708,4761,4447
66000060015,臺中市,西屯區,港尾里,臺中市第04選區,張廖萬堅,民主進步黨,1797,1297,1593,recall_agree_votes,500,2890,5025,4863
68000060005,桃園市,大園區,橫峰里,桃園市第02選區,黃世杰,民主進步黨,1514,1018,1124,recall_agree_votes,496,2142,3978,4076
66000070003,臺中市,南屯區,楓樹里,臺中市第04選區,張廖萬堅,民主進步黨,2285,1790,2008,recall_agree_votes,495,3798,6067,5916
66000070009,臺中市,南屯區,永定里,臺中市第04選區,張廖萬堅,民主進步黨,2013,1519,1612,recall_agree_votes,494,3131,5355,5093
66000070012,臺中市,南屯區,田心里,臺中市第04選區,張廖萬堅,民主進步黨,2335,1843,2038,recall_agree_votes,492,3881,6743,6331
68000060003,桃園市,大園區,溪海里,桃園市第02選區,黃世杰,民主進步黨,1610,1119,1240,recall_agree_votes,491,2359,4738,4441
63000030031,臺北市,大安區,通化里,臺北市第06選區,苗博雅,社會民主黨,1779,1288,1421,recall_agree_votes,491,2709,4704,4953
10009060016,雲林縣,北港鎮,新街里,雲林縣第01選區,蘇治芬,民主進步黨,2063,1573,1843,recall_agree_votes,490,3416,6353,6140
63000100023,臺北市,內湖區,東湖里,臺北市第04選區,高嘉瑜,民主進步黨,2187,1700,2093,recall_agree_votes,487,3793,6392,6538
66000040019,臺中市,西區,忠誠里,臺中市第06選區,江肇國,民主進步黨,1969,1490,1577,recall_agree_votes,479,3067,5326,5371
68000080003,桃園市,八德區,瑞豐里,桃園市第06選區,趙正宇,無黨籍及未經政黨推薦,1521,1047,1803,recall_agree_votes,474,2850,5679,5237
66000040009,臺中市,西區,公舘里,臺中市第06選區,江肇國,民主進步黨,1949,1476,1623,recall_agree_votes,473,3099,5355,5391
68000020033,桃園市,中壢區,復興里,桃園市第03選區,彭俊豪,民主進步黨,1230,767,1144,recall_agree_votes,463,1911,3769,3702
68000120015,桃園市,觀音區,富源里,桃園市第02選區,黃世杰,民主進步黨,1367,908,1293,recall_agree_votes,459,2201,4109,3954
63000100024,臺北市,內湖區,樂康里,臺北市第04選區,高嘉瑜,民主進步黨,2026,1567,1932,recall_agree_votes,459,3499,6060,6229
66000040016,臺中市,西區,忠明里,臺中市第06選區,江肇國,民主進步黨,2026,1567,1584,recall_agree_votes,459,3151,5624,5548
66000040018,臺中市,西區,土庫里,臺中市第06選區,江肇國,民主進步黨,2048,1593,1574,recall_agree_votes,455,3167,5328,5421
68000020022,桃園市,中壢區,洽溪里,桃園市第03選區,彭俊豪,民主進步黨,1884,1432,1593,recall_agree_votes,452,3025,5751,5115
68000020064,桃園市,中壢區,五福里,桃園市第03選區,彭俊豪,民主進步黨,1306,861,1007,recall_agree_votes,445,1868,3378,3455
68000020046,桃園市,中壢區,芝芭里,桃園市第03選區,彭俊豪,民主進步黨,1905,1461,1457,recall_agree_votes,444,2918,5521,4814
68000020088,桃園市,中壢區,興福里,桃園市第03選區,彭俊豪,民主進步黨,1305,862,1226,recall_agree_votes,443,2088,3624,3706
63000040025,臺北市,中山區,行仁里,臺北市第03選區,謝佩芬,民主進步黨,2412,1979,1813,recall_agree_votes,433,3792,6269,6440
63000020025,臺北市,信義區,中行里,臺北市第07選區,許淑華,民主進步黨,2315,1883,1882,recall_agree_votes,432,3765,6147,6339
66000070015,臺中市,南屯區,大同里,臺中市第04選區,張廖萬堅,民主進步黨,1770,1339,1482,recall_agree_votes,431,2821,4777,4793
68000120012,桃園市,觀音區,大同里,桃園市第02選區,黃世杰,民主進步黨,1238,814,746,recall_agree_votes,424,1560,2945,2963
66000070004,臺中市,南屯區,中和里,臺中市第04選區,張廖萬堅,民主進步黨,1584,1161,1266,recall_agree_votes,423,2427,3958,4064
68000020036,桃園市,中壢區,忠福里,桃園市第03選區,彭俊豪,民主進步黨,1338,917,1425,recall_agree_votes,421,2342,4062,3966
68000020070,桃園市,中壢區,仁義里,桃園市第03選區,彭俊豪,民主進步黨,1261,847,1163,recall_agree_votes,414,2010,3761,3717
66000060009,臺中市,西屯區,何安里,臺中市第04選區,張廖萬堅,民主進步黨,1726,1316,1499,recall_agree_votes,410,2815,5042,4927
66000040007,臺中市,西區,公民里,臺中市第06選區,江肇國,民主進步黨,1741,1332,1435,recall_agree_votes,409,2767,4663,4670
68000120021,桃園市,觀音區,草漯里,桃園市第02選區,黃世杰,民主進步黨,1290,883,1030,recall_agree_votes,407,1913,4223,3657
68000120017,桃園市,觀音區,新坡里,桃園市第02選區,黃世杰,民主進步黨,1169,762,775,recall_agree_votes,407,1537,2954,2900
66000060022,臺中市,西屯區,何德里,臺中市第04選區,張廖萬堅,民主進步黨,1329,926,1139,recall_agree_votes,403,2065,3544,3558
66000060011,臺中市,西屯區,大河里,臺中市第04選區,張廖萬堅,民主進步黨,1610,1207,1157,recall_agree_votes,403,2364,3864,3745
66000060017,臺中市,西屯區,林厝里,臺中市第04選區,張廖萬堅,民主進步黨,1225,824,1077,recall_agree_votes,401,1901,3292,3371
66000060032,臺中市,西屯區,何福里,臺中市第04選區,張廖萬堅,民主進步黨,1516,1115,1318,recall_agree_votes,401,2433,4090,4167
68000120022,桃園市,觀音區,樹林里,桃園市第02選區,黃世杰,民主進步黨,1272,873,1237,recall_agree_votes,399,2110,5083,4748
68000110001,桃園市,新屋區,新屋里,桃園市第02選區,黃世杰,民主進步黨,1022,623,892,recall_agree_votes,399,1515,2804,2776
68000020032,桃園市,中壢區,青埔里,桃園市第03選區,彭俊豪,民主進步黨,3238,2841,3428,recall_agree_votes,397,6269,12385,8941
68000020048,桃園市,中壢區,三民里,桃園市第03選區,彭俊豪,民主進步黨,1257,860,974,recall_agree_votes,397,1834,3192,3221
68000120011,桃園市,觀音區,藍埔里,桃園市第02選區,黃世杰,民主進步黨,1089,694,712,recall_agree_votes,395,1406,2525,2545
68000020031,桃園市,中壢區,水尾里,桃園市第03選區,彭俊豪,民主進步黨,1279,886,1160,recall_agree_votes,393,2046,3517,3596
65000010090,新北市,板橋區,華中里,新北市第07選區,羅致政,民主進步黨,1652,1260,1005,recall_agree_votes,392,2265,4257,4358
65000280003,新北市,萬里區,野柳里,新北市第12選區,賴品妤,民主進步黨,1056,666,691,recall_agree_votes,390,1357,2981,3058
68000110016,桃園市,新屋區,永安里,桃園市第02選區,黃世杰,民主進步黨,947,558,659,recall_agree_votes,389,1217,2081,2114
68000020024,桃園市,中壢區,新明里,桃園市第03選區,彭俊豪,民主進步黨,1273,887,1077,recall_agree_votes,386,1964,3564,3591
10017030010,基隆市,暖暖區,暖西里,基隆市第01選區,王醒之,無黨籍及未經政黨推薦,1442,1058,1454,recall_agree_votes,384,2512,4600,4661
66000040008,臺中市,西區,藍興里,臺中市第06選區,江肇國,民主進步黨,1471,1090,1263,recall_agree_votes,381,2353,3827,3836
68000060018,桃園市,大園區,北港里,桃園市第02選區,黃世杰,民主進步黨,1076,699,712,recall_agree_votes,377,1411,2889,2926
65000120012,新北市,瑞芳區,吉安里,新北市第12選區,賴品妤,民主進步黨,890,514,790,recall_agree_votes,376,1304,2707,2715
68000120018,桃園市,觀音區,廣福里,桃園市第02選區,黃世杰,民主進步黨,1080,705,697,recall_agree_votes,375,1402,2615,2589
68000100028,桃園市,平鎮區,義興里,桃園市第05選區,劉仁照,民主進步黨,1952,1577,2183,recall_agree_votes,375,3760,6540,6619
68000010010,桃園市,桃園區,汴洲里,桃園市第01選區,鄭運鵬,民主進步黨,2270,1898,2113,recall_agree_votes,372,4011,7434,7027
68000110012,桃園市,新屋區,下田里,桃園市第02選區,黃世杰,民主進步黨,743,373,493,recall_agree_votes,370,866,1646,1651
66000060016,臺中市,西屯區,廣福里,臺中市第04選區,張廖萬堅,民主進步黨,1007,639,605,recall_agree_votes,368,1244,2087,2167
68000120010,桃園市,觀音區,金湖里,桃園市第02選區,黃世杰,民主進步黨,950,582,701,recall_agree_votes,368,1283,2611,2561
10009060014,雲林縣,北港鎮,華勝里,雲林縣第01選區,蘇治芬,民主進步黨,1604,1237,1271,recall_agree_votes,367,2508,4503,4548
68000110006,桃園市,新屋區,埔頂里,桃園市第02選區,黃世杰,民主進步黨,941,577,830,recall_agree_votes,364,1407,2429,2458
10009130004,雲林縣,麥寮鄉,興華村,雲林縣第01選區,蘇治芬,民主進步黨,881,517,768,recall_agree_votes,364,1285,3026,2958
63000030002,臺北市,大安區,仁慈里,臺北市第06選區,苗博雅,社會民主黨,1553,1189,1207,recall_agree_votes,364,2396,4087,4199
63000010018,臺北市,松山區,慈祐里,臺北市第07選區,許淑華,民主進步黨,2235,1871,1733,recall_agree_votes,364,3604,6956,6956
63000040021,臺北市,中山區,松江里,臺北市第03選區,謝佩芬,民主進步黨,1889,1527,1455,recall_agree_votes,362,2982,5007,5111
68000050006,桃園市,蘆竹區,蘆竹里,桃園市第01選區,鄭運鵬,民主進步黨,1566,1205,934,recall_agree_votes,361,2139,3675,3779
68000050012,桃園市,蘆竹區,山腳里,桃園市第01選區,鄭運鵬,民主進步黨,1367,1006,785,recall_agree_votes,361,1791,3299,3390
68000050003,桃園市,蘆竹區,新莊里,桃園市第01選區,鄭運鵬,民主進步黨,1809,1451,1420,recall_agree_votes,358,2871,4982,4968
63000030012,臺北市,大安區,龍泉里,臺北市第06選區,苗博雅,社會民主黨,1384,1028,1167,recall_agree_votes,356,2195,3816,3885
68000020054,桃園市,中壢區,興和里,桃園市第03選區,彭俊豪,民主進步黨,1086,737,857,recall_agree_votes,349,1594,2566,2627
63000100006,臺北市,內湖區,港都里,臺北市第04選區,高嘉瑜,民主進步黨,1468,1119,1330,recall_agree_votes,349,2449,4062,4345
68000110007,桃園市,新屋區,九斗里,桃園市第02選區,黃世杰,民主進步黨,895,551,647,recall_agree_votes,344,1198,2197,2182
63000090008,臺北市,南港區,西新里,臺北市第04選區,高嘉瑜,民主進步黨,1363,1020,980,recall_agree_votes,343,2000,3548,3699
68000030004,桃園市,大溪區,一德里,桃園市第06選區,趙正宇,無黨籍及未經政黨推薦,1709,1367,1164,recall_agree_votes,342,2531,5004,5037
63000040027,臺北市,中山區,下埤里,臺北市第03選區,謝佩芬,民主進步黨,2290,1951,1839,recall_agree_votes,339,3790,6073,6223
66000070020,臺中市,南屯區,大興里,臺中市第04選區,張廖萬堅,民主進步黨,1574,1235,1324,recall_agree_votes,339,2559,4212,4278
68000080014,桃園市,八德區,大湳里,桃園市第06選區,趙正宇,無黨籍及未經政黨推薦,1226,892,1044,recall_agree_votes,334,1936,3805,3776
65000010096,新北市,板橋區,聚安里,新北市第07選區,羅致政,民主進步黨,1552,1221,1081,recall_agree_votes,331,2302,4256,4367
63000100030,臺北市,內湖區,湖元里,臺北市第04選區,高嘉瑜,民主進步黨,1708,1377,1652,recall_agree_votes,331,3029,5316,5279
65000030059,新北市,中和區,文元里,新北市第08選區,吳崢,民主進步黨,1451,1127,1215,recall_agree_votes,324,2342,4204,4326
63000040008,臺北市,中山區,集英里,臺北市第03選區,謝佩芬,民主進步黨,2120,1803,1450,recall_agree_votes,317,3253,5818,5680
63000040022,臺北市,中山區,新生里,臺北市第03選區,謝佩芬,民主進步黨,1433,1116,1055,recall_agree_votes,317,2171,3633,3813
68000110010,桃園市,新屋區,石磊里,桃園市第02選區,黃世杰,民主進步黨,869,552,661,recall_agree_votes,317,1213,2296,2251
68000080015,桃園市,八德區,大安里,桃園市第06選區,趙正宇,無黨籍及未經政黨推薦,1139,823,879,recall_agree_votes,316,1702,3306,3330
68000050002,桃園市,蘆竹區,中福里,桃園市第01選區,鄭運鵬,民主進步黨,1545,1231,927,recall_agree_votes,314,2158,3802,3955
66000040012,臺中市,西區,後龍里,臺中市第06選區,江肇國,民主進步黨,1238,926,961,recall_agree_votes,312,1887,3301,3243
65000280002,新北市,萬里區,龜吼里,新北市第12選區,賴品妤,民主進步黨,813,502,607,recall_agree_votes,311,1109,2639,2481
68000020021,桃園市,中壢區,東興里,桃園市第03選區,彭俊豪,民主進步黨,1113,802,1102,recall_agree_votes,311,1904,3284,3208
65000280004,新北市,萬里區,大鵬里,新北市第12選區,賴品妤,民主進步黨,850,542,631,recall_agree_votes,308,1173,2512,2553
66000060030,臺中市,西屯區,何明里,臺中市第04選區,張廖萬堅,民主進步黨,1220,915,1056,recall_agree_votes,305,1971,3316,3359
68000060017,桃園市,大園區,內海里,桃園市第02選區,黃世杰,民主進步黨,849,544,608,recall_agree_votes,305,1152,2141,2173
63000020015,臺北市,信義區,長春里,臺北市第07選區,許淑華,民主進步黨,1295,991,1016,recall_agree_votes,304,2007,3335,3463
68000120004,桃園市,觀音區,大潭里,桃園市第02選區,黃世杰,民主進步黨,768,467,639,recall_agree_votes,301,1106,2224,2160
68000100024,桃園市,平鎮區,東勢里,桃園市第05選區,劉仁照,民主進步黨,1563,1265,1438,recall_agree_votes,298,2703,5098,4974
65000010094,新北市,板橋區,大安里,新北市第07選區,羅致政,民主進步黨,1203,906,958,recall_agree_votes,297,1864,3305,3359
68000020015,桃園市,中壢區,中央里,桃園市第03選區,彭俊豪,民主進步黨,1128,832,1148,recall_agree_votes,296,1980,3278,3304
68000120016,桃園市,觀音區,上大里,桃園市第02選區,黃世杰,民主進步黨,919,624,783,recall_agree_votes,295,1407,2589,2468
65000030089,新北市,中和區,嘉慶里,新北市第08選區,吳崢,民主進步黨,1116,821,1015,recall_agree_votes,295,1836,3459,3620
68000050001,桃園市,蘆竹區,新興里,桃園市第01選區,鄭運鵬,民主進步黨,1197,902,693,recall_agree_votes,295,1595,2813,2819
68000060010,桃園市,大園區,三石里,桃園市第02選區,黃世杰,民主進步黨,1101,808,780,recall_agree_votes,293,1588,2641,2707
63000040023,臺北市,中山區,中庄里,臺北市第03選區,謝佩芬,民主進步黨,1569,1277,1173,recall_agree_votes,292,2450,4138,4217
68000110017,桃園市,新屋區,笨港里,桃園市第02選區,黃世杰,民主進步黨,507,215,303,recall_agree_votes,292,518,966,1009
68000120006,桃園市,觀音區,保生里,桃園市第02選區,黃世杰,民主進步黨,779,492,564,recall_agree_votes,287,1056,2025,2117
66000040021,臺中市,西區,中興里,臺中市第06選區,江肇國,民主進步黨,1386,1100,969,recall_agree_votes,286,2069,3384,3426
63000040031,臺北市,中山區,中原里,臺北市第03選區,謝佩芬,民主進步黨,1562,1277,1197,recall_agree_votes,285,2474,4056,4133
10017030008,基隆市,暖暖區,暖暖里,基隆市第01選區,王醒之,無黨籍及未經政黨推薦,841,556,812,recall_agree_votes,285,1368,2419,2483
68000110003,桃園市,新屋區,後湖里,桃園市第02選區,黃世杰,民主進步黨,598,318,479,recall_agree_votes,280,797,1451,1424
63000020014,臺北市,信義區,永吉里,臺北市第07選區,許淑華,民主進步黨,1280,1000,790,recall_agree_votes,280,1790,3023,3146
68000020080,桃園市,中壢區,興平里,桃園市第03選區,彭俊豪,民主進步黨,939,660,715,recall_agree_votes,279,1375,2292,2344
68000050022,桃園市,蘆竹區,上竹里,桃園市第01選區,鄭運鵬,民主進步黨,1166,887,981,recall_agree_votes,279,1868,3367,3394
63000040030,臺北市,中山區,中吉里,臺北市第03選區,謝佩芬,民主進步黨,1742,1464,1123,recall_agree_votes,278,2587,4405,4545
63000040039,臺北市,中山區,力行里,臺北市第03選區,謝佩芬,民主進步黨,1779,1501,1450,recall_agree_votes,278,2951,5015,5164
10009060025,雲林縣,北港鎮,樹腳里,雲林縣第01選區,蘇治芬,民主進步黨,1100,823,657,recall_agree_votes,277,1480,2849,2821
68000080026,桃園市,八德區,大仁里,桃園市第06選區,趙正宇,無黨籍及未經政黨推薦,1273,996,1175,recall_agree_votes,277,2171,3886,3942
65000010091,新北市,板橋區,僑中里,新北市第07選區,羅致政,民主進步黨,1272,995,969,recall_agree_votes,277,1964,3465,3553
65000010099,新北市,板橋區,溪洲里,新北市第07選區,羅致政,民主進步黨,1592,1316,1292,recall_agree_votes,276,2608,4740,4797
63000020010,臺北市,信義區,六藝里,臺北市第07選區,許淑華,民主進步黨,1097,823,913,recall_agree_votes,274,1736,2878,2959
68000070026,桃園市,龜山區,新嶺里,桃園市第01選區,鄭運鵬,民主進步黨,1080,810,1031,recall_agree_votes,270,1841,3532,3505
68000110022,桃園市,新屋區,大坡里,桃園市第02選區,黃世杰,民主進步黨,570,301,350,recall_agree_votes,269,651,1294,1286
68000020086,桃園市,中壢區,青溪里,桃園市第03選區,彭俊豪,民主進步黨,1178,910,1153,recall_agree_votes,268,2063,3670,3258
68000060020,桃園市,大園區,青峰里,桃園市第02選區,黃世杰,民主進步黨,1338,1070,1398,recall_agree_votes,268,2468,4604,3965
65000030057,新北市,中和區,員山里,新北市第08選區,吳崢,民主進步黨,1643,1375,1669,recall_agree_votes,268,3044,5380,5364
68000030018,桃園市,大溪區,仁愛里,桃園市第06選區,趙正宇,無黨籍及未經政黨推薦,1341,1075,1457,recall_agree_votes,266,2532,4562,4560
63000040029,臺北市,中山區,江山里,臺北市第03選區,謝佩芬,民主進步黨,2274,2009,1718,recall_agree_votes,265,3727,6007,6108
68000030021,桃園市,大溪區,南興里,桃園市第06選區,趙正宇,無黨籍及未經政黨推薦,1385,1120,1196,recall_agree_votes,265,2316,4612,4668
65000030060,新北市,中和區,嘉新里,新北市第08選區,吳崢,民主進步黨,1076,813,996,recall_agree_votes,263,1809,3385,3456
10009170001,雲林縣,元長鄉,長南村,雲林縣第01選區,蘇治芬,民主進步黨,984,721,767,recall_agree_votes,263,1488,3063,3101
65000010120,新北市,板橋區,居仁里,新北市第07選區,羅致政,民主進步黨,1220,958,887,recall_agree_votes,262,1845,3269,3300
65000010054,新北市,板橋區,埔墘里,新北市第07選區,羅致政,民主進步黨,1816,1556,1543,recall_agree_votes,260,3099,5349,5400
63000020013,臺北市,信義區,五全里,臺北市第07選區,許淑華,民主進步黨,1545,1285,1205,recall_agree_votes,260,2490,3909,3968
63000040018,臺北市,中山區,新喜里,臺北市第03選區,謝佩芬,民主進步黨,1528,1269,1127,recall_agree_votes,259,2396,4076,4167
65000010089,新北市,板橋區,浮洲里,新北市第07選區,羅致政,民主進步黨,1152,894,697,recall_agree_votes,258,1591,2965,3117
63000040020,臺北市,中山區,新福里,臺北市第03選區,謝佩芬,民主進步黨,1617,1361,1092,recall_agree_votes,256,2453,4134,4102
65000270004,新北市,金山區,磺港里,新北市第12選區,賴品妤,民主進步黨,691,436,285,recall_agree_votes,255,721,1547,1627
65000010112,新北市,板橋區,堂春里,新北市第07選區,羅致政,民主進步黨,1232,978,873,recall_agree_votes,254,1851,3434,3499
66000040020,臺中市,西區,公益里,臺中市第06選區,江肇國,民主進步黨,1020,767,803,recall_agree_votes,253,1570,2572,2612
65000120011,新北市,瑞芳區,吉慶里,新北市第12選區,賴品妤,民主進步黨,535,282,489,recall_agree_votes,253,771,1543,1608
65000280010,新北市,萬里區,北基里,新北市第12選區,賴品妤,民主進步黨,729,477,579,recall_agree_votes,252,1056,2466,2487
65000010097,新北市,板橋區,龍安里,新北市第07選區,羅致政,民主進步黨,906,654,619,recall_agree_votes,252,1273,2267,2324
65000030061,新北市,中和區,民安里,新北市第08選區,吳崢,民主進步黨,1397,1145,1319,recall_agree_votes,252,2464,4411,4404
68000060021,桃園市,大園區,青山里,桃園市第02選區,黃世杰,民主進步黨,1352,1101,1171,recall_agree_votes,251,2272,4019,3503
10017030012,基隆市,暖暖區,碇安里,基隆市第01選區,王醒之,無黨籍及未經政黨推薦,1228,977,1519,recall_agree_votes,251,2496,4715,4719
10009130008,雲林縣,麥寮鄉,三盛村,雲林縣第01選區,蘇治芬,民主進步黨,639,390,512,recall_agree_votes,249,902,2215,2231
68000080011,桃園市,八德區,茄苳里,桃園市第06選區,趙正宇,無黨籍及未經政黨推薦,815,566,662,recall_agree_votes,249,1228,2368,2376
65000010123,新北市,板橋區,五權里,新北市第07選區,羅致政,民主進步黨,1193,945,1005,recall_agree_votes,248,1950,3397,3433
66000070008,臺中市,南屯區,新生里,臺中市第04選區,張廖萬堅,民主進步黨,1146,899,1083,recall_agree_votes,247,1982,3660,3131
68000020013,桃園市,中壢區,仁愛里,桃園市第06選區,趙正宇,無黨籍及未經政黨推薦,838,591,969,recall_agree_votes,247,1560,2854,2848
68000100012,桃園市,平鎮區,平鎮里,桃園市第05選區,劉仁照,民主進步黨,1264,1018,1343,recall_agree_votes,246,2361,4282,4292
65000010052,新北市,板橋區,振義里,新北市第07選區,羅致政,民主進步黨,1396,1150,920,recall_agree_votes,246,2070,3517,3570
68000070016,桃園市,龜山區,嶺頂里,桃園市第01選區,鄭運鵬,民主進步黨,1194,949,956,recall_agree_votes,245,1905,3725,3738
65000010068,新北市,板橋區,東丘里,新北市第07選區,羅致政,民主進步黨,1377,1133,955,recall_agree_votes,244,2088,3691,3785
68000070024,桃園市,龜山區,龍華里,桃園市第01選區,鄭運鵬,民主進步黨,1078,834,904,recall_agree_votes,244,1738,3348,3256
68000080013,桃園市,八德區,白鷺里,桃園市第06選區,趙正宇,無黨籍及未經政黨推薦,944,701,857,recall_agree_votes,243,1558,2797,2841
10009160006,雲林縣,臺西鄉,牛厝村,雲林縣第01選區,蘇治芬,民主進步黨,525,282,411,recall_agree_votes,243,693,1670,1718
65000010051,新北市,板橋區,振興里,新北市第07選區,羅致政,民主進步黨,1360,1118,1046,recall_agree_votes,242,2164,3665,3763
68000080036,桃園市,八德區,大千里,桃園市第06選區,趙正宇,無黨籍及未經政黨推薦,651,409,773,recall_agree_votes,242,1182,2094,2108
66000020003,臺中市,東區,東橋里,臺中市第06選區,江肇國,民主進步黨,1331,1090,933,recall_agree_votes,241,2023,3499,3576
65000010083,新北市,板橋區,廣福里,新北市第07選區,羅致政,民主進步黨,1120,879,835,recall_agree_votes,241,1714,3235,3314
65000010059,新北市,板橋區,玉光里,新北市第07選區,羅致政,民主進步黨,1493,1253,1243,recall_agree_votes,240,2496,4607,4508
63000020016,臺北市,信義區,四育里,臺北市第07選區,許淑華,民主進步黨,1723,1484,1349,recall_agree_votes,239,2833,4410,4482
68000100002,桃園市,平鎮區,高雙里,桃園市第05選區,劉仁照,民主進步黨,1341,1102,1369,recall_agree_votes,239,2471,4294,4289
66000080034,臺中市,北屯區,北京里,臺中市第05選區,莊競程,民主進步黨,1021,783,885,recall_agree_votes,238,1668,2901,2989
68000010018,桃園市,桃園區,西埔里,桃園市第04選區,范綱祥,民主進步黨,1084,847,835,recall_agree_votes,237,1682,2943,2984
10009200001,雲林縣,水林鄉,水北村,雲林縣第01選區,蘇治芬,民主進步黨,685,448,446,recall_agree_votes,237,894,1988,2030
68000030025,桃園市,大溪區,田心里,桃園市第06選區,趙正宇,無黨籍及未經政黨推薦,1429,1192,999,recall_agree_votes,237,2191,4059,4081
65000120013,新北市,瑞芳區,傑魚里,新北市第12選區,賴品妤,民主進步黨,565,329,473,recall_agree_votes,236,802,1711,1769
68000080029,桃園市,八德區,大昌里,桃園市第06選區,趙正宇,無黨籍及未經政黨推薦,842,606,865,recall_agree_votes,236,1471,2611,2653
68000120001,桃園市,觀音區,觀音里,桃園市第02選區,黃世杰,民主進步黨,863,627,801,recall_agree_votes,236,1428,2963,2780
68000110009,桃園市,新屋區,東明里,桃園市第02選區,黃世杰,民主進步黨,592,356,480,recall_agree_votes,236,836,1431,1388
68000050039,桃園市,蘆竹區,正興里,桃園市第01選區,鄭運鵬,民主進步黨,1288,1053,1182,recall_agree_votes,235,2235,4303,4202
68000080041,桃園市,八德區,大愛里,桃園市第06選區,趙正宇,無黨籍及未經政黨推薦,728,494,850,recall_agree_votes,234,1344,2347,2387
68000080007,桃園市,八德區,廣興里,桃園市第06選區,趙正宇,無黨籍及未經政黨推薦,961,731,944,recall_agree_votes,230,1675,2988,3045
66000060010,臺中市,西屯區,何厝里,臺中市第04選區,張廖萬堅,民主進步黨,1073,843,920,recall_agree_votes,230,1763,3126,3064
65000270006,新北市,金山區,五湖里,新北市第12選區,賴品妤,民主進步黨,566,336,482,recall_agree_votes,230,818,1543,1582
63000040019,臺北市,中山區,新庄里,臺北市第03選區,謝佩芬,民主進步黨,1485,1256,1174,recall_agree_votes,229,2430,3940,4032
68000050040,桃園市,蘆竹區,濱海里,桃園市第01選區,鄭運鵬,民主進步黨,735,506,603,recall_agree_votes,229,1109,2256,2362
68000110023,桃園市,新屋區,望間里,桃園市第02選區,黃世杰,民主進步黨,593,364,386,recall_agree_votes,229,750,1360,1316
65000120030,新北市,瑞芳區,瑞濱里,新北市第12選區,賴品妤,民主進步黨,498,274,454,recall_agree_votes,224,728,1529,1552
68000110008,桃園市,新屋區,社子里,桃園市第02選區,黃世杰,民主進步黨,567,343,424,recall_agree_votes,224,767,1323,1305
68000120009,桃園市,觀音區,坑尾里,桃園市第02選區,黃世杰,民主進步黨,630,408,516,recall_agree_votes,222,924,1895,1857
68000120023,桃園市,觀音區,富林里,桃園市第02選區,黃世杰,民主進步黨,733,511,559,recall_agree_votes,222,1070,2120,2024
63000040032,臺北市,中山區,興亞里,臺北市第03選區,謝佩芬,民主進步黨,1602,1381,1296,recall_agree_votes,221,2677,4546,4561
63000100038,臺北市,內湖區,麗山里,臺北市第04選區,高嘉瑜,民主進步黨,1620,1400,1449,recall_agree_votes,220,2849,4702,4819
63000040026,臺北市,中山區,行孝里,臺北市第03選區,謝佩芬,民主進步黨,1339,1120,1053,recall_agree_votes,219,2173,3623,3675
65000030003,新北市,中和區,信和里,新北市第08選區,吳崢,民主進步黨,1129,910,1032,recall_agree_votes,219,1942,3487,3596
68000120020,桃園市,觀音區,保障里,桃園市第02選區,黃世杰,民主進步黨,818,600,467,recall_agree_votes,218,1067,1979,1947
65000030066,新北市,中和區,自強里,新北市第08選區,吳崢,民主進步黨,1327,1110,1176,recall_agree_votes,217,2286,4154,4231
68000120013,桃園市,觀音區,大堀里,桃園市第02選區,黃世杰,民主進步黨,615,398,389,recall_agree_votes,217,787,1530,1560
10009190019,雲林縣,口湖鄉,梧南村,雲林縣第01選區,蘇治芬,民主進步黨,619,403,379,recall_agree_votes,216,782,1617,1669
66000080014,臺中市,北屯區,大坑里,臺中市第05選區,莊競程,民主進步黨,762,547,594,recall_agree_votes,215,1141,2077,2090
66000040010,臺中市,西區,和龍里,臺中市第06選區,江肇國,民主進步黨,822,610,571,recall_agree_votes,212,1181,2175,2170
68000050023,桃園市,蘆竹區,宏竹里,桃園市第01選區,鄭運鵬,民主進步黨,1089,877,770,recall_agree_votes,212,1647,2907,2894
66000050016,臺中市,北區,賴村里,臺中市第05選區,莊競程,民主進步黨,1416,1205,1275,recall_agree_votes,211,2480,4303,4136
65000260008,新北市,貢寮區,真理里,新北市第12選區,賴品妤,民主進步黨,767,557,199,recall_agree_votes,210,756,1804,1863
65000010064,新北市,板橋區,廣新里,新北市第07選區,羅致政,民主進步黨,945,736,782,recall_agree_votes,209,1518,2859,2932
65000030062,新北市,中和區,安穗里,新北市第08選區,吳崢,民主進步黨,1217,1008,1110,recall_agree_votes,209,2118,3764,3799
10009200002,雲林縣,水林鄉,水南村,雲林縣第01選區,蘇治芬,民主進步黨,712,504,440,recall_agree_votes,208,944,1904,1916
66000010002,臺中市,中區,大墩里,臺中市第06選區,江肇國,民主進步黨,673,465,524,recall_agree_votes,208,989,1846,1858
65000010066,新北市,板橋區,香丘里,新北市第07選區,羅致政,民主進步黨,1027,820,792,recall_agree_votes,207,1612,2893,2991
65000260007,新北市,貢寮區,仁里里,新北市第12選區,賴品妤,民主進步黨,601,395,268,recall_agree_votes,206,663,1576,1591
68000130001,桃園市,復興區,三民里,桃園市第06選區,趙正宇,無黨籍及未經政黨推薦,504,298,372,recall_agree_votes,206,670,1405,1426
63000030009,臺北市,大安區,誠安里,臺北市第06選區,苗博雅,社會民主黨,1087,882,949,recall_agree_votes,205,1831,3261,3234
68000050010,桃園市,蘆竹區,內厝里,桃園市第01選區,鄭運鵬,民主進步黨,826,621,505,recall_agree_votes,205,1126,2410,2462
68000060016,桃園市,大園區,圳頭里,桃園市第02選區,黃世杰,民主進步黨,730,527,550,recall_agree_votes,203,1077,1908,1943
10009130003,雲林縣,麥寮鄉,瓦磘村,雲林縣第01選區,蘇治芬,民主進步黨,609,407,424,recall_agree_votes,202,831,1931,1967
68000110014,桃園市,新屋區,赤欄里,桃園市第02選區,黃世杰,民主進步黨,497,295,392,recall_agree_votes,202,687,1302,1231
68000080018,桃園市,八德區,大同里,桃園市第06選區,趙正宇,無黨籍及未經政黨推薦,561,359,364,recall_agree_votes,202,723,1420,1427
65000010069,新北市,板橋區,長安里,新北市第07選區,羅致政,民主進步黨,1222,1020,1020,recall_agree_votes,202,2040,3460,3573
68000080044,桃園市,八德區,廣德里,桃園市第06選區,趙正宇,無黨籍及未經政黨推薦,791,590,835,recall_agree_votes,201,1425,2485,2559
68000100037,桃園市,平鎮區,新榮里,桃園市第05選區,劉仁照,民主進步黨,1472,1273,1681,recall_agree_votes,199,2954,4981,4988
10009140010,雲林縣,東勢鄉,同安村,雲林縣第01選區,蘇治芬,民主進步黨,559,361,466,recall_agree_votes,198,827,1726,1799
68000080031,桃園市,八德區,大強里,桃園市第06選區,趙正宇,無黨籍及未經政黨推薦,1025,827,962,recall_agree_votes,198,1789,3023,3021
10009190008,雲林縣,口湖鄉,下崙村,雲林縣第01選區,蘇治芬,民主進步黨,534,337,363,recall_agree_votes,197,700,1841,1897
65000010100,新北市,板橋區,溪北里,新北市第07選區,羅致政,民主進步黨,1006,809,826,recall_agree_votes,197,1635,2892,2940
65000010125,新北市,板橋區,大觀里,新北市第07選區,羅致政,民主進步黨,1082,886,717,recall_agree_votes,196,1603,2989,3028
68000110020,桃園市,新屋區,槺榔里,桃園市第02選區,黃世杰,民主進步黨,453,257,254,recall_agree_votes,196,511,999,1008
65000120009,新北市,瑞芳區,東和里,新北市第12選區,賴品妤,民主進步黨,520,324,413,recall_agree_votes,196,737,1480,1505
63000010028,臺北市,松山區,美仁里,臺北市第07選區,許淑華,民主進步黨,995,799,763,recall_agree_votes,196,1562,2644,2694
68000110015,桃園市,新屋區,永興里,桃園市第02選區,黃世杰,民主進步黨,451,257,266,recall_agree_votes,194,523,1008,1001
10009140003,雲林縣,東勢鄉,嘉隆村,雲林縣第01選區,蘇治芬,民主進步黨,521,328,329,recall_agree_votes,193,657,1384,1440
10009160005,雲林縣,臺西鄉,溪頂村,雲林縣第01選區,蘇治芬,民主進步黨,391,199,349,recall_agree_votes,192,548,1332,1358
68000110021,桃園市,新屋區,後庄里,桃園市第02選區,黃世杰,民主進步黨,419,228,354,recall_agree_votes,191,582,1000,1040
65000010063,新北市,板橋區,雙玉里,新北市第07選區,羅致政,民主進步黨,1179,989,901,recall_agree_votes,190,1890,3351,3404
10017020018,基隆市,七堵區,百福里,基隆市第01選區,鄭文婷,民主進步黨,1536,1346,1586,recall_agree_votes,190,2932,5694,5706
65000250012,新北市,雙溪區,泰平里,新北市第12選區,賴品妤,民主進步黨,361,172,240,recall_agree_votes,189,412,1104,1119
65000280009,新北市,萬里區,中幅里,新北市第12選區,賴品妤,民主進步黨,406,217,230,recall_agree_votes,189,447,1003,1033
65000120031,新北市,瑞芳區,深澳里,新北市第12選區,賴品妤,民主進步黨,341,153,354,recall_agree_votes,188,507,1120,1163
68000030013,桃園市,大溪區,瑞興里,桃園市第06選區,趙正宇,無黨籍及未經政黨推薦,826,638,421,recall_agree_votes,188,1059,2045,2119
68000030003,桃園市,大溪區,一心里,桃園市第06選區,趙正宇,無黨籍及未經政黨推薦,1334,1149,1107,recall_agree_votes,185,2256,4522,4457
65000010055,新北市,板橋區,長壽里,新北市第07選區,羅致政,民主進步黨,928,743,640,recall_agree_votes,185,1383,2409,2457
68000080016,桃園市,八德區,大興里,桃園市第06選區,趙正宇,無黨籍及未經政黨推薦,1184,1000,1262,recall_agree_votes,184,2262,4100,3808
66000050019,臺中市,北區,中達里,臺中市第05選區,莊競程,民主進步黨,827,644,712,recall_agree_votes,183,1356,2461,2484
68000080019,桃園市,八德區,大成里,桃園市第06選區,趙正宇,無黨籍及未經政黨推薦,999,816,963,recall_agree_votes,183,1779,2998,3086
68000030007,桃園市,大溪區,美華里,桃園市第06選區,趙正宇,無黨籍及未經政黨推薦,1040,857,694,recall_agree_votes,183,1551,2852,2908
68000020038,桃園市,中壢區,石頭里,桃園市第03選區,彭俊豪,民主進步黨,562,380,459,recall_agree_votes,182,839,1555,1556
65000030016,新北市,中和區,福祥里,新北市第08選區,吳崢,民主進步黨,1356,1175,1374,recall_agree_votes,181,2549,4238,4299
63000040036,臺北市,中山區,朱園里,臺北市第03選區,謝佩芬,民主進步黨,1345,1164,1048,recall_agree_votes,181,2212,3753,3731
68000080034,桃園市,八德區,大竹里,桃園市第06選區,趙正宇,無黨籍及未經政黨推薦,548,368,400,recall_agree_votes,180,768,1421,1418
66000070014,臺中市,南屯區,鎮平里,臺中市第04選區,張廖萬堅,民主進步黨,567,388,344,recall_agree_votes,179,732,1213,1234
65000030013,新北市,中和區,福真里,新北市第08選區,吳崢,民主進步黨,1080,902,1103,recall_agree_votes,178,2005,3593,3609
68000080012,桃園市,八德區,高明里,桃園市第06選區,趙正宇,無黨籍及未經政黨推薦,990,813,1059,recall_agree_votes,177,1872,3543,3591
68000120003,桃園市,觀音區,廣興里,桃園市第02選區,黃世杰,民主進步黨,436,259,417,recall_agree_votes,177,676,1269,1254
65000030090,新北市,中和區,冠穗里,新北市第08選區,吳崢,民主進步黨,951,775,876,recall_agree_votes,176,1651,2752,2824
65000170014,新北市,林口區,太平里,新北市第01選區,何博文,民主進步黨,558,383,302,recall_agree_votes,175,685,1351,1405
63000040004,臺北市,中山區,民安里,臺北市第03選區,謝佩芬,民主進步黨,1332,1157,947,recall_agree_votes,175,2104,3653,3689
68000100027,桃園市,平鎮區,鎮興里,桃園市第05選區,劉仁照,民主進步黨,859,685,923,recall_agree_votes,174,1608,2915,2872
68000050015,桃園市,蘆竹區,坑口里,桃園市第01選區,鄭運鵬,民主進步黨,766,592,527,recall_agree_votes,174,1119,1996,2104
65000030064,新北市,中和區,明穗里,新北市第08選區,吳崢,民主進步黨,1210,1037,1079,recall_agree_votes,173,2116,3653,3760
65000030086,新北市,中和區,錦盛里,新北市第08選區,吳崢,民主進步黨,980,807,998,recall_agree_votes,173,1805,3178,3262
65000030088,新北市,中和區,員富里,新北市第08選區,吳崢,民主進步黨,955,783,897,recall_agree_votes,172,1680,3167,3162
65000280006,新北市,萬里區,雙興里,新北市第12選區,賴品妤,民主進步黨,381,209,220,recall_agree_votes,172,429,898,929
66000080011,臺中市,北屯區,東山里,臺中市第05選區,莊競程,民主進步黨,780,609,526,recall_agree_votes,171,1135,2012,1970
68000050014,桃園市,蘆竹區,坑子里,桃園市第01選區,鄭運鵬,民主進步黨,705,534,284,recall_agree_votes,171,818,1527,1547
68000080033,桃園市,八德區,大明里,桃園市第06選區,趙正宇,無黨籍及未經政黨推薦,989,818,973,recall_agree_votes,171,1791,3431,3414
65000030012,新北市,中和區,廟美里,新北市第08選區,吳崢,民主進步黨,1104,938,1203,recall_agree_votes,166,2141,3718,3785
10009060024,雲林縣,北港鎮,好收里,雲林縣第01選區,蘇治芬,民主進步黨,559,394,328,recall_agree_votes,165,722,1435,1468
68000050019,桃園市,蘆竹區,長興里,桃園市第01選區,鄭運鵬,民主進步黨,757,592,652,recall_agree_votes,165,1244,2497,2491
68000030014,桃園市,大溪區,中新里,桃園市第06選區,趙正宇,無黨籍及未經政黨推薦,588,424,335,recall_agree_votes,164,759,1456,1459
65000120010,新北市,瑞芳區,上天里,新北市第12選區,賴品妤,民主進步黨,376,212,338,recall_agree_votes,164,550,1138,1184
68000110019,桃園市,新屋區,蚵間里,桃園市第02選區,黃世杰,民主進步黨,393,230,221,recall_agree_votes,163,451,866,869
65000030071,新北市,中和區,明德里,新北市第08選區,吳崢,民主進步黨,986,824,948,recall_agree_votes,162,1772,3251,3305
68000060004,桃園市,大園區,和平里,桃園市第02選區,黃世杰,民主進步黨,642,480,394,recall_agree_votes,162,874,1551,1587
68000080047,桃園市,八德區,永豐里,桃園市第06選區,趙正宇,無黨籍及未經政黨推薦,862,701,868,recall_agree_votes,161,1569,2907,2816
68000080002,桃園市,八德區,福興里,桃園市第06選區,趙正宇,無黨籍及未經政黨推薦,1093,932,1392,recall_agree_votes,161,2324,4773,4402
68000100031,桃園市,平鎮區,廣達里,桃園市第05選區,劉仁照,民主進步黨,1222,1061,1240,recall_agree_votes,161,2301,3878,3853
10009150001,雲林縣,褒忠鄉,中民村,雲林縣第01選區,蘇治芬,民主進步黨,591,431,552,recall_agree_votes,160,983,1750,1762
10009140005,雲林縣,東勢鄉,月眉村,雲林縣第01選區,蘇治芬,民主進步黨,369,211,278,recall_agree_votes,158,489,1022,1072
10009170020,雲林縣,元長鄉,崙仔村,雲林縣第01選區,蘇治芬,民主進步黨,289,132,180,recall_agree_votes,157,312,732,765
68000060014,桃園市,大園區,沙崙里,桃園市第02選區,黃世杰,民主進步黨,462,305,427,recall_agree_votes,157,732,1332,1394
66000050028,臺中市,北區,大湖里,臺中市第05選區,莊競程,民主進步黨,665,509,503,recall_agree_votes,156,1012,1955,2031
65000010058,新北市,板橋區,九如里,新北市第07選區,羅致政,民主進步黨,913,757,625,recall_agree_votes,156,1382,2354,2446
68000020035,桃園市,中壢區,興國里,桃園市第03選區,彭俊豪,民主進步黨,630,474,621,recall_agree_votes,156,1095,1943,1802
65000030004,新北市,中和區,仁和里,新北市第08選區,吳崢,民主進步黨,987,832,1013,recall_agree_votes,155,1845,3259,3351
68000080048,桃園市,八德區,大順里,桃園市第06選區,趙正宇,無黨籍及未經政黨推薦,658,503,700,recall_agree_votes,155,1203,2161,2286
63000040012,臺北市,中山區,圓山里,臺北市第03選區,謝佩芬,民主進步黨,1195,1041,894,recall_agree_votes,154,1935,3381,3434
10009150004,雲林縣,褒忠鄉,新湖村,雲林縣第01選區,蘇治芬,民主進步黨,423,269,255,recall_agree_votes,154,524,1034,1093
10009150005,雲林縣,褒忠鄉,馬鳴村,雲林縣第01選區,蘇治芬,民主進步黨,491,337,378,recall_agree_votes,154,715,1329,1340
10017020019,基隆市,七堵區,實踐里,基隆市第01選區,鄭文婷,民主進步黨,912,758,984,recall_agree_votes,154,1742,3465,3445
65000010076,新北市,板橋區,福星里,新北市第07選區,羅致政,民主進步黨,1033,881,892,recall_agree_votes,152,1773,2917,2943
65000260006,新北市,貢寮區,福隆里,新北市第12選區,賴品妤,民主進步黨,463,312,320,recall_agree_votes,151,632,1451,1498
10009050011,雲林縣,土庫鎮,東平里,雲林縣第01選區,蘇治芬,民主進步黨,625,474,461,recall_agree_votes,151,935,1754,1793
63000030008,臺北市,大安區,昌隆里,臺北市第06選區,苗博雅,社會民主黨,896,745,795,recall_agree_votes,151,1540,2576,2580
66000040013,臺中市,西區,安龍里,臺中市第06選區,江肇國,民主進步黨,984,833,825,recall_agree_votes,151,1658,2818,2679
10009060026,雲林縣,北港鎮,扶朝里,雲林縣第01選區,蘇治芬,民主進步黨,486,336,124,recall_agree_votes,150,460,872,908
10009150002,雲林縣,褒忠鄉,埔姜村,雲林縣第01選區,蘇治芬,民主進步黨,441,291,449,recall_agree_votes,150,740,1386,1400
10009200003,雲林縣,水林鄉,海埔村,雲林縣第01選區,蘇治芬,民主進步黨,387,238,164,recall_agree_votes,149,402,880,922
10009190009,雲林縣,口湖鄉,崙中村,雲林縣第01選區,蘇治芬,民主進步黨,388,240,282,recall_agree_votes,148,522,1369,1398
10009190007,雲林縣,口湖鄉,蚵寮村,雲林縣第01選區,蘇治芬,民主進步黨,431,283,251,recall_agree_votes,148,534,1275,1311
68000070012,桃園市,龜山區,大坑里,桃園市第01選區,鄭運鵬,民主進步黨,661,513,455,recall_agree_votes,148,968,1807,1837
68000110013,桃園市,新屋區,石牌里,桃園市第02選區,黃世杰,民主進步黨,348,202,273,recall_agree_votes,146,475,840,876
10017030005,基隆市,暖暖區,碇內里,基隆市第01選區,王醒之,無黨籍及未經政黨推薦,631,486,855,recall_agree_votes,145,1341,2469,2500
68000020045,桃園市,中壢區,舊明里,桃園市第03選區,彭俊豪,民主進步黨,535,390,390,recall_agree_votes,145,780,1330,1351
10009190012,雲林縣,口湖鄉,港東村,雲林縣第01選區,蘇治芬,民主進步黨,372,228,307,recall_agree_votes,144,535,1317,1396
10009050014,雲林縣,土庫鎮,西平里,雲林縣第01選區,蘇治芬,民主進步黨,510,366,429,recall_agree_votes,144,795,1602,1667
65000010122,新北市,板橋區,東安里,新北市第07選區,羅致政,民主進步黨,715,571,488,recall_agree_votes,144,1059,1899,1919
10017030004,基隆市,暖暖區,過港里,基隆市第01選區,王醒之,無黨籍及未經政黨推薦,900,756,1066,recall_agree_votes,144,1822,3490,3485
10009200004,雲林縣,水林鄉,土厝村,雲林縣第01選區,蘇治芬,民主進步黨,476,333,184,recall_agree_votes,143,517,1093,1077
68000030008,桃園市,大溪區,福安里,桃園市第06選區,趙正宇,無黨籍及未經政黨推薦,832,689,443,recall_agree_votes,143,1132,2064,2108
10009050016,雲林縣,土庫鎮,崙內里,雲林縣第01選區,蘇治芬,民主進步黨,441,299,429,recall_agree_votes,142,728,1430,1454
10009190020,雲林縣,口湖鄉,梧北村,雲林縣第01選區,蘇治芬,民主進步黨,498,356,180,recall_agree_votes,142,536,1078,1090
68000110011,桃園市,新屋區,下埔里,桃園市第02選區,黃世杰,民主進步黨,325,183,199,recall_agree_votes,142,382,668,689
68000050030,桃園市,蘆竹區,蘆興里,桃園市第01選區,鄭運鵬,民主進步黨,533,392,456,recall_agree_votes,141,848,1540,1565
10017020010,基隆市,七堵區,堵北里,基隆市第01選區,鄭文婷,民主進步黨,935,794,980,recall_agree_votes,141,1774,3351,3414
10009170014,雲林縣,元長鄉,龍岩村,雲林縣第01選區,蘇治芬,民主進步黨,360,219,182,recall_agree_votes,141,401,872,900
10009180003,雲林縣,四湖鄉,溪底村,雲林縣第01選區,蘇治芬,民主進步黨,306,166,262,recall_agree_votes,140,428,841,879
10009060019,雲林縣,北港鎮,草湖里,雲林縣第01選區,蘇治芬,民主進步黨,512,372,215,recall_agree_votes,140,587,1279,1267
10009190015,雲林縣,口湖鄉,成龍村,雲林縣第01選區,蘇治芬,民主進步黨,292,153,166,recall_agree_votes,139,319,809,836
65000010085,新北市,板橋區,華貴里,新北市第07選區,羅致政,民主進步黨,742,603,590,recall_agree_votes,139,1193,2053,2133
10009200013,雲林縣,水林鄉,大山村,雲林縣第01選區,蘇治芬,民主進步黨,412,274,160,recall_agree_votes,138,434,941,956
68000050013,桃園市,蘆竹區,外社里,桃園市第01選區,鄭運鵬,民主進步黨,641,504,265,recall_agree_votes,137,769,1404,1452
10009190010,雲林縣,口湖鄉,崙東村,雲林縣第01選區,蘇治芬,民主進步黨,384,247,327,recall_agree_votes,137,574,1285,1342
68000120005,桃園市,觀音區,武威里,桃園市第02選區,黃世杰,民主進步黨,379,242,288,recall_agree_votes,137,530,918,915
68000090024,桃園市,龍潭區,聖德里,桃園市第05選區,劉仁照,民主進步黨,798,661,847,recall_agree_votes,137,1508,2786,2775
10009050007,雲林縣,土庫鎮,奮起里,雲林縣第01選區,蘇治芬,民主進步黨,364,228,321,recall_agree_votes,136,549,1168,1199
66000060004,臺中市,西屯區,龍潭里,臺中市第04選區,張廖萬堅,民主進步黨,427,291,302,recall_agree_votes,136,593,1081,983
68000060013,桃園市,大園區,海口里,桃園市第02選區,黃世杰,民主進步黨,346,211,326,recall_agree_votes,135,537,953,968
66000040003,臺中市,西區,三民里,臺中市第06選區,江肇國,民主進步黨,623,488,489,recall_agree_votes,135,977,2304,2294
10009170018,雲林縣,元長鄉,瓦磘村,雲林縣第01選區,蘇治芬,民主進步黨,455,321,269,recall_agree_votes,134,590,1300,1368
68000120019,桃園市,觀音區,塔腳里,桃園市第02選區,黃世杰,民主進步黨,355,221,293,recall_agree_votes,134,514,949,1005
65000260011,新北市,貢寮區,和美里,新北市第12選區,賴品妤,民主進步黨,366,233,126,recall_agree_votes,133,359,867,904
66000010003,臺中市,中區,綠川里,臺中市第06選區,江肇國,民主進步黨,537,404,393,recall_agree_votes,133,797,1451,1423
68000100036,桃園市,平鎮區,北富里,桃園市第05選區,劉仁照,民主進步黨,1083,950,1077,recall_agree_votes,133,2027,3568,3686
65000250006,新北市,雙溪區,牡丹里,新北市第12選區,賴品妤,民主進步黨,376,244,311,recall_agree_votes,132,555,1272,1331
66000010005,臺中市,中區,光復里,臺中市第06選區,江肇國,民主進步黨,599,467,492,recall_agree_votes,132,959,1734,1810
68000110018,桃園市,新屋區,深圳里,桃園市第02選區,黃世杰,民主進步黨,273,141,200,recall_agree_votes,132,341,596,603
65000260009,新北市,貢寮區,福連里,新北市第12選區,賴品妤,民主進步黨,305,173,150,recall_agree_votes,132,323,803,840
10009190014,雲林縣,口湖鄉,台子村,雲林縣第01選區,蘇治芬,民主進步黨,611,480,331,recall_agree_votes,131,811,1747,1813
10009050008,雲林縣,土庫鎮,埤腳里,雲林縣第01選區,蘇治芬,民主進步黨,380,250,303,recall_agree_votes,130,553,1116,1159
65000030091,新北市,中和區,國華里,新北市第08選區,吳崢,民主進步黨,913,783,844,recall_agree_votes,130,1627,2848,2877
65000030083,新北市,中和區,中山里,新北市第08選區,吳崢,民主進步黨,696,567,681,recall_agree_votes,129,1248,2291,2313
65000100013,新北市,淡水區,水源里,新北市第01選區,何博文,民主進步黨,649,521,471,recall_agree_votes,128,992,1860,1875
65000030058,新北市,中和區,嘉穗里,新北市第08選區,吳崢,民主進步黨,799,672,736,recall_agree_votes,127,1408,2496,2401
68000010027,桃園市,桃園區,南華里,桃園市第04選區,范綱祥,民主進步黨,477,350,317,recall_agree_votes,127,667,1275,1284
10009170013,雲林縣,元長鄉,下寮村,雲林縣第01選區,蘇治芬,民主進步黨,429,303,387,recall_agree_votes,126,690,1381,1396
10009200008,雲林縣,水林鄉,蘇秦村,雲林縣第01選區,蘇治芬,民主進步黨,331,205,138,recall_agree_votes,126,343,863,892
66000050027,臺中市,北區,六合里,臺中市第05選區,莊競程,民主進步黨,565,440,414,recall_agree_votes,125,854,1654,1660
65000270007,新北市,金山區,重和里,新北市第12選區,賴品妤,民主進步黨,387,262,247,recall_agree_votes,125,509,1160,1110
68000030022,桃園市,大溪區,瑞源里,桃園市第06選區,趙正宇,無黨籍及未經政黨推薦,974,849,1007,recall_agree_votes,125,1856,3430,3455
66000010006,臺中市,中區,柳川里,臺中市第06選區,江肇國,民主進步黨,535,411,476,recall_agree_votes,124,887,1873,1813
10009190004,雲林縣,口湖鄉,埔北村,雲林縣第01選區,蘇治芬,民主進步黨,284,161,169,recall_agree_votes,123,330,789,834
68000010031,桃園市,桃園區,北門里,桃園市第04選區,范綱祥,民主進步黨,576,453,455,recall_agree_votes,123,908,1624,1654
68000010009,桃園市,桃園區,永興里,桃園市第04選區,范綱祥,民主進步黨,603,481,432,recall_agree_votes,122,913,1798,1768
68000120008,桃園市,觀音區,新興里,桃園市第02選區,黃世杰,民主進步黨,299,178,246,recall_agree_votes,121,424,767,753
66000010004,臺中市,中區,公園里,臺中市第06選區,江肇國,民主進步黨,471,350,357,recall_agree_votes,121,707,1359,1326
10009180008,雲林縣,四湖鄉,蔡厝村,雲林縣第01選區,蘇治芬,民主進步黨,260,140,155,recall_agree_votes,120,295,735,775
68000030012,桃園市,大溪區,義和里,桃園市第06選區,趙正宇,無黨籍及未經政黨推薦,630,510,346,recall_agree_votes,120,856,1613,1618
68000070017,桃園市,龜山區,龍壽里,桃園市第01選區,鄭運鵬,民主進步黨,639,520,274,recall_agree_votes,119,794,1580,1601
65000120003,新北市,瑞芳區,龍鎮里,新北市第12選區,賴品妤,民主進步黨,378,259,335,recall_agree_votes,119,594,1106,1150
10009180021,雲林縣,四湖鄉,萡東村,雲林縣第01選區,蘇治芬,民主進步黨,341,222,130,recall_agree_votes,119,352,928,950
68000080050,桃園市,八德區,福德里,桃園市第06選區,趙正宇,無黨籍及未經政黨推薦,701,582,868,recall_agree_votes,119,1450,2834,2703
10009200014,雲林縣,水林鄉,大溝村,雲林縣第01選區,蘇治芬,民主進步黨,347,229,190,recall_agree_votes,118,419,876,916
65000030056,新北市,中和區,民享里,新北市第08選區,吳崢,民主進步黨,729,612,658,recall_agree_votes,117,1270,2071,2117
65000010108,新北市,板橋區,正泰里,新北市第07選區,羅致政,民主進步黨,874,758,744,recall_agree_votes,116,1502,2444,2494
65000120033,新北市,瑞芳區,鼻頭里,新北市第12選區,賴品妤,民主進步黨,238,122,157,recall_agree_votes,116,279,775,796
10009050017,雲林縣,土庫鎮,新庄里,雲林縣第01選區,蘇治芬,民主進步黨,427,311,357,recall_agree_votes,116,668,1282,1338
65000110038,新北市,汐止區,環河里,新北市第12選區,賴品妤,民主進步黨,465,350,237,recall_agree_votes,115,587,1040,1102
10009180016,雲林縣,四湖鄉,萡子村,雲林縣第01選區,蘇治芬,民主進步黨,292,178,103,recall_agree_votes,114,281,756,805
10009170002,雲林縣,元長鄉,長北村,雲林縣第01選區,蘇治芬,民主進步黨,413,299,349,recall_agree_votes,114,648,1324,1375
10009150006,雲林縣,褒忠鄉,有才村,雲林縣第01選區,蘇治芬,民主進步黨,263,149,216,recall_agree_votes,114,365,770,788
65000010126,新北市,板橋區,歡園里,新北市第07選區,羅致政,民主進步黨,413,301,256,recall_agree_votes,112,557,952,1003
10009180012,雲林縣,四湖鄉,羊調村,雲林縣第01選區,蘇治芬,民主進步黨,247,135,228,recall_agree_votes,112,363,800,838
68000070011,桃園市,龜山區,南上里,桃園市第01選區,鄭運鵬,民主進步黨,641,530,526,recall_agree_votes,111,1056,1781,1804
65000010109,新北市,板橋區,民生里,新北市第07選區,羅致政,民主進步黨,658,547,479,recall_agree_votes,111,1026,1797,1829
10009200012,雲林縣,水林鄉,尖山村,雲林縣第01選區,蘇治芬,民主進步黨,251,140,129,recall_agree_votes,111,269,600,620
65000170010,新北市,林口區,頂福里,新北市第01選區,何博文,民主進步黨,382,271,167,recall_agree_votes,111,438,901,938
10009180004,雲林縣,四湖鄉,鹿場村,雲林縣第01選區,蘇治芬,民主進步黨,272,161,207,recall_agree_votes,111,368,803,817
66000080015,臺中市,北屯區,民德里,臺中市第05選區,莊競程,民主進步黨,344,233,269,recall_agree_votes,111,502,928,929
10009170008,雲林縣,元長鄉,潭西村,雲林縣第01選區,蘇治芬,民主進步黨,300,189,99,recall_agree_votes,111,288,654,687
68000050021,桃園市,蘆竹區,富竹里,桃園市第01選區,鄭運鵬,民主進步黨,656,546,348,recall_agree_votes,110,894,1521,1380
10009150003,雲林縣,褒忠鄉,中勝村,雲林縣第01選區,蘇治芬,民主進步黨,461,351,379,recall_agree_votes,110,730,1325,1375
68000020004,桃園市,中壢區,永興里,桃園市第03選區,彭俊豪,民主進步黨,300,190,253,recall_agree_votes,110,443,869,875
10009190016,雲林縣,口湖鄉,湖口村,雲林縣第01選區,蘇治芬,民主進步黨,298,188,193,recall_agree_votes,110,381,894,936
68000080037,桃園市,八德區,大榮里,桃園市第06選區,趙正宇,無黨籍及未經政黨推薦,500,391,578,recall_agree_votes,109,969,1757,1781
68000080001,桃園市,八德區,興仁里,桃園市第06選區,趙正宇,無黨籍及未經政黨推薦,929,820,1174,recall_agree_votes,109,1994,4871,4254
65000010053,新北市,板橋區,光復里,新北市第07選區,羅致政,民主進步黨,972,863,738,recall_agree_votes,109,1601,2803,2830
10009170003,雲林縣,元長鄉,子茂村,雲林縣第01選區,蘇治芬,民主進步黨,382,274,355,recall_agree_votes,108,629,1183,1242
68000120002,桃園市,觀音區,白玉里,桃園市第02選區,黃世杰,民主進步黨,297,189,270,recall_agree_votes,108,459,827,826
68000060012,桃園市,大園區,竹圍里,桃園市第02選區,黃世杰,民主進步黨,351,243,312,recall_agree_votes,108,555,883,951
10009060021,雲林縣,北港鎮,後溝里,雲林縣第01選區,蘇治芬,民主進步黨,343,235,205,recall_agree_votes,108,440,883,917
10009060020,雲林縣,北港鎮,溝皂里,雲林縣第01選區,蘇治芬,民主進步黨,368,260,261,recall_agree_votes,108,521,1020,1075
65000010067,新北市,板橋區,西安里,新北市第07選區,羅致政,民主進步黨,751,644,567,recall_agree_votes,107,1211,2193,2229
68000060015,桃園市,大園區,後厝里,桃園市第02選區,黃世杰,民主進步黨,296,190,260,recall_agree_votes,106,450,747,785
65000270009,新北市,金山區,六股里,新北市第12選區,賴品妤,民主進步黨,268,163,140,recall_agree_votes,105,303,608,632
66000010001,臺中市,中區,繼光里,臺中市第06選區,江肇國,民主進步黨,492,388,339,recall_agree_votes,104,727,1350,1396
10009140006,雲林縣,東勢鄉,程海村,雲林縣第01選區,蘇治芬,民主進步黨,217,114,153,recall_agree_votes,103,267,499,522
10009140011,雲林縣,東勢鄉,新坤村,雲林縣第01選區,蘇治芬,民主進步黨,281,178,284,recall_agree_votes,103,462,930,967
10017040013,基隆市,仁愛區,吉仁里,基隆市第01選區,鄭文婷,民主進步黨,649,546,666,recall_agree_votes,103,1212,2376,2396
65000010060,新北市,板橋區,光仁里,新北市第07選區,羅致政,民主進步黨,796,694,656,recall_agree_votes,102,1350,2327,2325
65000240011,新北市,平溪區,十分里,新北市第12選區,賴品妤,民主進步黨,232,130,172,recall_agree_votes,102,302,742,760
10009170012,雲林縣,元長鄉,頂寮村,雲林縣第01選區,蘇治芬,民主進步黨,337,235,254,recall_agree_votes,102,489,1041,1065
10009170005,雲林縣,元長鄉,山內村,雲林縣第01選區,蘇治芬,民主進步黨,308,206,199,recall_agree_votes,102,405,869,883
10009060018,雲林縣,北港鎮,府番里,雲林縣第01選區,蘇治芬,民主進步黨,245,145,201,recall_agree_votes,100,346,745,748
10009200021,雲林縣,水林鄉,瓊埔村,雲林縣第01選區,蘇治芬,民主進步黨,272,174,94,recall_agree_votes,98,268,594,616
10009170015,雲林縣,元長鄉,西莊村,雲林縣第01選區,蘇治芬,民主進步黨,280,182,194,recall_agree_votes,98,376,776,785
10009170021,雲林縣,元長鄉,新吉村,雲林縣第01選區,蘇治芬,民主進步黨,233,136,180,recall_agree_votes,97,316,625,650
68000020040,桃園市,中壢區,中建里,桃園市第03選區,彭俊豪,民主進步黨,383,286,303,recall_agree_votes,97,589,1026,980
10017010018,基隆市,中正區,平寮里,基隆市第01選區,鄭文婷,民主進步黨,304,208,282,recall_agree_votes,96,490,1066,1104
68000010015,桃園市,桃園區,萬壽里,桃園市第01選區,鄭運鵬,民主進步黨,325,229,223,recall_agree_votes,96,452,837,871
10009180002,雲林縣,四湖鄉,新庄村,雲林縣第01選區,蘇治芬,民主進步黨,201,106,173,recall_agree_votes,95,279,562,586
10009140012,雲林縣,東勢鄉,四美村,雲林縣第01選區,蘇治芬,民主進步黨,267,173,211,recall_agree_votes,94,384,904,937
10009060017,雲林縣,北港鎮,劉厝里,雲林縣第01選區,蘇治芬,民主進步黨,397,303,253,recall_agree_votes,94,556,1045,1065
65000170006,新北市,林口區,湖北里,新北市第01選區,何博文,民主進步黨,510,416,314,recall_agree_votes,94,730,1220,1262
65000120008,新北市,瑞芳區,柑坪里,新北市第12選區,賴品妤,民主進步黨,344,250,221,recall_agree_votes,94,471,958,988
10009140008,雲林縣,東勢鄉,安南村,雲林縣第01選區,蘇治芬,民主進步黨,238,144,169,recall_agree_votes,94,313,727,745
10014030001,臺東縣,關山鎮,德高里,臺東縣第01選區,許瑞貴,無黨籍及未經政黨推薦,228,134,280,recall_agree_votes,94,414,954,1006
68000080035,桃園市,八德區,大慶里,桃園市第06選區,趙正宇,無黨籍及未經政黨推薦,400,307,391,recall_agree_votes,93,698,1307,1332
10009050009,雲林縣,土庫鎮,大荖里,雲林縣第01選區,蘇治芬,民主進步黨,289,197,239,recall_agree_votes,92,436,806,824
10009140007,雲林縣,東勢鄉,龍潭村,雲林縣第01選區,蘇治芬,民主進步黨,282,190,165,recall_agree_votes,92,355,728,756
68000030005,桃園市,大溪區,月眉里,桃園市第06選區,趙正宇,無黨籍及未經政黨推薦,457,365,253,recall_agree_votes,92,618,1143,1168
65000030065,新北市,中和區,清穗里,新北市第08選區,吳崢,民主進步黨,873,781,893,recall_agree_votes,92,1674,2884,2821
68000030010,桃園市,大溪區,新峰里,桃園市第06選區,趙正宇,無黨籍及未經政黨推薦,266,174,150,recall_agree_votes,92,324,713,740
10009170004,雲林縣,元長鄉,後湖村,雲林縣第01選區,蘇治芬,民主進步黨,269,177,125,recall_agree_votes,92,302,628,665
10009200015,雲林縣,水林鄉,順興村,雲林縣第01選區,蘇治芬,民主進步黨,269,177,122,recall_agree_votes,92,299,732,740
10009170006,雲林縣,元長鄉,合和村,雲林縣第01選區,蘇治芬,民主進步黨,335,243,276,recall_agree_votes,92,519,967,975
10009200024,雲林縣,水林鄉,溪墘村,雲林縣第01選區,蘇治芬,民主進步黨,264,173,213,recall_agree_votes,91,386,715,740
65000250004,新北市,雙溪區,魚行里,新北市第12選區,賴品妤,民主進步黨,204,114,153,recall_agree_votes,90,267,556,610
10009150009,雲林縣,褒忠鄉,潮厝村,雲林縣第01選區,蘇治芬,民主進步黨,271,181,176,recall_agree_votes,90,357,777,810
10009200005,雲林縣,水林鄉,春埔村,雲林縣第01選區,蘇治芬,民主進步黨,321,231,189,recall_agree_votes,90,420,859,890
10009170010,雲林縣,元長鄉,客厝村,雲林縣第01選區,蘇治芬,民主進步黨,243,154,207,recall_agree_votes,89,361,759,787
68000030006,桃園市,大溪區,永福里,桃園市第06選區,趙正宇,無黨籍及未經政黨推薦,397,308,154,recall_agree_votes,89,462,889,892
65000260010,新北市,貢寮區,美豐里,新北市第12選區,賴品妤,民主進步黨,244,156,143,recall_agree_votes,88,299,644,677
10009170016,雲林縣,元長鄉,鹿北村,雲林縣第01選區,蘇治芬,民主進步黨,301,213,322,recall_agree_votes,88,535,1060,1062
65000100014,新北市,淡水區,忠寮里,新北市第01選區,何博文,民主進步黨,358,271,279,recall_agree_votes,87,550,978,1012
10009180011,雲林縣,四湖鄉,內湖村,雲林縣第01選區,蘇治芬,民主進步黨,192,105,145,recall_agree_votes,87,250,701,713
65000270014,新北市,金山區,永興里,新北市第12選區,賴品妤,民主進步黨,200,113,82,recall_agree_votes,87,195,506,533
10009170009,雲林縣,元長鄉,潭東村,雲林縣第01選區,蘇治芬,民主進步黨,203,117,158,recall_agree_votes,86,275,519,535
10009180017,雲林縣,四湖鄉,林厝村,雲林縣第01選區,蘇治芬,民主進步黨,279,194,186,recall_agree_votes,85,380,922,960
10014070001,臺東縣,東河鄉,北源村,臺東縣第01選區,劉櫂豪,無黨籍及未經政黨推薦,172,87,184,recall_agree_votes,85,271,809,822
10009060023,雲林縣,北港鎮,大北里,雲林縣第01選區,蘇治芬,民主進步黨,212,127,105,recall_agree_votes,85,232,506,515
10017020020,基隆市,七堵區,長安里,基隆市第01選區,鄭文婷,民主進步黨,531,447,594,recall_agree_votes,84,1041,2071,2071
65000170012,新北市,林口區,嘉寶里,新北市第01選區,何博文,民主進步黨,350,267,195,recall_agree_votes,83,462,819,855
65000280007,新北市,萬里區,溪底里,新北市第12選區,賴品妤,民主進步黨,241,158,102,recall_agree_votes,83,260,597,610
68000010020,桃園市,桃園區,中和里,桃園市第04選區,范綱祥,民主進步黨,444,361,316,recall_agree_votes,83,677,1236,1261
10009060008,雲林縣,北港鎮,西勢里,雲林縣第01選區,蘇治芬,民主進步黨,303,220,259,recall_agree_votes,83,479,913,901
65000270011,新北市,金山區,清泉里,新北市第12選區,賴品妤,民主進步黨,250,168,197,recall_agree_votes,82,365,751,758
10009190011,雲林縣,口湖鄉,青蚶村,雲林縣第01選區,蘇治芬,民主進步黨,179,97,73,recall_agree_votes,82,170,449,467
10009180014,雲林縣,四湖鄉,崙南村,雲林縣第01選區,蘇治芬,民主進步黨,181,99,169,recall_agree_votes,82,268,718,740
66000050026,臺中市,北區,中正里,臺中市第05選區,莊競程,民主進步黨,398,316,298,recall_agree_votes,82,614,1059,1171
10009200017,雲林縣,水林鄉,山腳村,雲林縣第01選區,蘇治芬,民主進步黨,271,190,149,recall_agree_votes,81,339,703,716
68000030009,桃園市,大溪區,復興里,桃園市第06選區,趙正宇,無黨籍及未經政黨推薦,286,205,182,recall_agree_votes,81,387,796,828
10009200016,雲林縣,水林鄉,蕃薯村,雲林縣第01選區,蘇治芬,民主進步黨,322,241,185,recall_agree_votes,81,426,870,891
10017010016,基隆市,中正區,社寮里,基隆市第01選區,鄭文婷,民主進步黨,427,347,387,recall_agree_votes,80,734,1491,1532
68000120007,桃園市,觀音區,三和里,桃園市第02選區,黃世杰,民主進步黨,307,227,218,recall_agree_votes,80,445,795,805
10014070002,臺東縣,東河鄉,泰源村,臺東縣第01選區,劉櫂豪,無黨籍及未經政黨推薦,136,56,107,recall_agree_votes,80,163,367,384
10014030002,臺東縣,關山鎮,豐泉里,臺東縣第01選區,許瑞貴,無黨籍及未經政黨推薦,202,122,326,recall_agree_votes,80,448,899,900
10009140004,雲林縣,東勢鄉,復興村,雲林縣第01選區,蘇治芬,民主進步黨,204,125,149,recall_agree_votes,79,274,484,496
65000170013,新北市,林口區,瑞平里,新北市第01選區,何博文,民主進步黨,278,199,160,recall_agree_votes,79,359,688,728
68000080040,桃園市,八德區,瑞興里,桃園市第06選區,趙正宇,無黨籍及未經政黨推薦,855,777,925,recall_agree_votes,78,1702,2967,2669
65000250008,新北市,雙溪區,平林里,新北市第12選區,賴品妤,民主進步黨,251,173,215,recall_agree_votes,78,388,778,785
65000120028,新北市,瑞芳區,濓洞里,新北市第12選區,賴品妤,民主進步黨,137,60,117,recall_agree_votes,77,177,389,409
65000260001,新北市,貢寮區,貢寮里,新北市第12選區,賴品妤,民主進步黨,219,142,153,recall_agree_votes,77,295,701,723
10014110002,臺東縣,綠島鄉,中寮村,臺東縣第01選區,劉櫂豪,無黨籍及未經政黨推薦,171,94,239,recall_agree_votes,77,333,1016,1015
10009190005,雲林縣,口湖鄉,埔南村,雲林縣第01選區,蘇治芬,民主進步黨,261,185,141,recall_agree_votes,76,326,654,674
65000250009,新北市,雙溪區,上林里,新北市第12選區,賴品妤,民主進步黨,197,122,145,recall_agree_votes,75,267,533,547
68000090017,桃園市,龍潭區,三坑里,桃園市第05選區,劉仁照,民主進步黨,446,371,464,recall_agree_votes,75,835,1509,1455
10017040015,基隆市,仁愛區,英仁里,基隆市第01選區,鄭文婷,民主進步黨,348,273,328,recall_agree_votes,75,601,1156,1169
10009150007,雲林縣,褒忠鄉,田洋村,雲林縣第01選區,蘇治芬,民主進步黨,237,163,206,recall_agree_votes,74,369,701,713
10009200022,雲林縣,水林鄉,塭底村,雲林縣第01選區,蘇治芬,民主進步黨,230,156,96,recall_agree_votes,74,252,613,627
10017070008,基隆市,信義區,智誠里,基隆市第01選區,鄭文婷,民主進步黨,371,298,382,recall_agree_votes,73,680,1355,1406
68000070009,桃園市,龜山區,公西里,桃園市第01選區,鄭運鵬,民主進步黨,429,356,353,recall_agree_votes,73,709,1229,1249
66000080012,臺中市,北屯區,民政里,臺中市第05選區,莊競程,民主進步黨,327,255,274,recall_agree_votes,72,529,1012,991
10017040029,基隆市,仁愛區,光華里,基隆市第01選區,鄭文婷,民主進步黨,647,575,690,recall_agree_votes,72,1265,2421,2446
10009160009,雲林縣,臺西鄉,五榔村,雲林縣第01選區,蘇治芬,民主進步黨,194,122,78,recall_agree_votes,72,200,413,424
65000280005,新北市,萬里區,磺潭里,新北市第12選區,賴品妤,民主進步黨,174,102,158,recall_agree_votes,72,260,519,555
10009200023,雲林縣,水林鄉,後寮村,雲林縣第01選區,蘇治芬,民主進步黨,217,146,132,recall_agree_votes,71,278,575,612
65000270002,新北市,金山區,大同里,新北市第12選區,賴品妤,民主進步黨,206,136,165,recall_agree_votes,70,301,624,651
65000270003,新北市,金山區,豐漁里,新北市第12選區,賴品妤,民主進步黨,191,121,109,recall_agree_votes,70,230,465,485
10009140009,雲林縣,東勢鄉,昌南村,雲林縣第01選區,蘇治芬,民主進步黨,253,183,236,recall_agree_votes,70,419,779,789
68000090008,桃園市,龍潭區,三水里,桃園市第05選區,劉仁照,民主進步黨,245,175,198,recall_agree_votes,70,373,632,649
65000260003,新北市,貢寮區,雙玉里,新北市第12選區,賴品妤,民主進步黨,194,126,108,recall_agree_votes,68,234,558,591
63000040017,臺北市,中山區,大佳里,臺北市第03選區,謝佩芬,民主進步黨,307,240,120,recall_agree_votes,67,360,601,721
68000100040,桃園市,平鎮區,北安里,桃園市第05選區,劉仁照,民主進步黨,487,421,477,recall_agree_votes,66,898,1626,1555
65000260005,新北市,貢寮區,龍門里,新北市第12選區,賴品妤,民主進步黨,260,194,79,recall_agree_votes,66,273,587,596
10009190003,雲林縣,口湖鄉,頂湖村,雲林縣第01選區,蘇治芬,民主進步黨,163,97,157,recall_agree_votes,66,254,568,585
10009060002,雲林縣,北港鎮,光民里,雲林縣第01選區,蘇治芬,民主進步黨,263,198,174,recall_agree_votes,65,372,611,640
65000270012,新北市,金山區,萬壽里,新北市第12選區,賴品妤,民主進步黨,189,124,84,recall_agree_votes,65,208,413,425
10009060022,雲林縣,北港鎮,番溝里,雲林縣第01選區,蘇治芬,民主進步黨,244,179,131,recall_agree_votes,65,310,680,704
68000010007,桃園市,桃園區,長美里,桃園市第04選區,范綱祥,民主進步黨,379,316,239,recall_agree_votes,63,555,988,979
65000270008,新北市,金山區,兩湖里,新北市第12選區,賴品妤,民主進步黨,148,85,98,recall_agree_votes,63,183,376,374
10009190018,雲林縣,口湖鄉,後厝村,雲林縣第01選區,蘇治芬,民主進步黨,246,183,122,recall_agree_votes,63,305,620,649
10009060004,雲林縣,北港鎮,南安里,雲林縣第01選區,蘇治芬,民主進步黨,290,228,232,recall_agree_votes,62,460,733,760
68000030001,桃園市,大溪區,興和里,桃園市第06選區,趙正宇,無黨籍及未經政黨推薦,491,429,345,recall_agree_votes,62,774,1285,1320
68000010021,桃園市,桃園區,文昌里,桃園市第04選區,范綱祥,民主進步黨,284,222,240,recall_agree_votes,62,462,834,721
10009200010,雲林縣,水林鄉,灣西村,雲林縣第01選區,蘇治芬,民主進步黨,269,208,174,recall_agree_votes,61,382,819,835
10009200019,雲林縣,水林鄉,松中村,雲林縣第01選區,蘇治芬,民主進步黨,196,135,72,recall_agree_votes,61,207,449,458
10009200020,雲林縣,水林鄉,松西村,雲林縣第01選區,蘇治芬,民主進步黨,210,149,109,recall_agree_votes,61,258,577,596
10014040007,臺東縣,卑南鄉,美農村,臺東縣第01選區,賴坤成,民主進步黨,285,224,223,recall_agree_votes,61,447,914,932
65000240006,新北市,平溪區,嶺腳里,新北市第12選區,賴品妤,民主進步黨,149,89,128,recall_agree_votes,60,217,507,555
65000120016,新北市,瑞芳區,弓橋里,新北市第12選區,賴品妤,民主進步黨,145,85,74,recall_agree_votes,60,159,274,283
10009060001,雲林縣,北港鎮,東陽里,雲林縣第01選區,蘇治芬,民主進步黨,253,194,179,recall_agree_votes,59,373,636,649
68000100009,桃園市,平鎮區,北勢里,桃園市第05選區,劉仁照,民主進步黨,708,649,783,recall_agree_votes,59,1432,2370,2336
10009200011,雲林縣,水林鄉,萬興村,雲林縣第01選區,蘇治芬,民主進步黨,257,198,112,recall_agree_votes,59,310,611,644
10009200007,雲林縣,水林鄉,車港村,雲林縣第01選區,蘇治芬,民主進步黨,198,139,102,recall_agree_votes,59,241,517,544
10009170011,雲林縣,元長鄉,卓運村,雲林縣第01選區,蘇治芬,民主進步黨,144,85,50,recall_agree_votes,59,135,311,320
66000050003,臺中市,北區,五常里,臺中市第05選區,莊競程,民主進步黨,400,341,324,recall_agree_votes,59,665,1221,1237
65000250010,新北市,雙溪區,外柑里,新北市第12選區,賴品妤,民主進步黨,118,59,100,recall_agree_votes,59,159,364,379
10009190006,雲林縣,口湖鄉,謝厝村,雲林縣第01選區,蘇治芬,民主進步黨,313,255,202,recall_agree_votes,58,457,919,926
68000030002,桃園市,大溪區,福仁里,桃園市第06選區,趙正宇,無黨籍及未經政黨推薦,382,324,194,recall_agree_votes,58,518,909,927
68000030011,桃園市,大溪區,康安里,桃園市第06選區,趙正宇,無黨籍及未經政黨推薦,472,414,245,recall_agree_votes,58,659,1203,1186
10009180007,雲林縣,四湖鄉,湖寮村,雲林縣第01選區,蘇治芬,民主進步黨,182,125,129,recall_agree_votes,57,254,639,666
10014030004,臺東縣,關山鎮,中福里,臺東縣第01選區,許瑞貴,無黨籍及未經政黨推薦,172,115,225,recall_agree_votes,57,340,633,668
10014030005,臺東縣,關山鎮,里壠里,臺東縣第01選區,許瑞貴,無黨籍及未經政黨推薦,234,178,403,recall_agree_votes,56,581,1171,1203
10009050013,雲林縣,土庫鎮,北平里,雲林縣第01選區,蘇治芬,民主進步黨,265,209,198,recall_agree_votes,56,407,764,785
10017020011,基隆市,七堵區,堵南里,基隆市第01選區,鄭文婷,民主進步黨,498,443,543,recall_agree_votes,55,986,1963,1879
10014040008,臺東縣,卑南鄉,賓朗村,臺東縣第01選區,賴坤成,民主進步黨,426,372,413,recall_agree_votes,54,785,1492,1529
10009200009,雲林縣,水林鄉,灣東村,雲林縣第01選區,蘇治芬,民主進步黨,167,114,139,recall_agree_votes,53,253,529,554
10009060012,雲林縣,北港鎮,大同里,雲林縣第01選區,蘇治芬,民主進步黨,357,305,281,recall_agree_votes,52,586,1043,1060
10014040006,臺東縣,卑南鄉,初鹿村,臺東縣第01選區,賴坤成,民主進步黨,198,146,240,recall_agree_votes,52,386,731,777
63000080037,臺北市,文山區,老泉里,臺北市第08選區,王閔生,民主進步黨,283,231,202,recall_agree_votes,52,433,713,719
65000280008,新北市,萬里區,崁脚里,新北市第12選區,賴品妤,民主進步黨,144,93,80,recall_agree_votes,51,173,352,368
68000080010,桃園市,八德區,霄裡里,桃園市第06選區,趙正宇,無黨籍及未經政黨推薦,546,496,634,recall_agree_votes,50,1130,2086,2041
10009060003,雲林縣,北港鎮,東華里,雲林縣第01選區,蘇治芬,民主進步黨,132,82,130,recall_agree_votes,50,212,369,391
10017040009,基隆市,仁愛區,仁德里,基隆市第01選區,鄭文婷,民主進步黨,241,192,215,recall_agree_votes,49,407,744,786
65000110017,新北市,汐止區,八連里,新北市第12選區,賴品妤,民主進步黨,311,262,249,recall_agree_votes,49,511,914,916
65000120014,新北市,瑞芳區,猴硐里,新北市第12選區,賴品妤,民主進步黨,122,75,70,recall_agree_votes,47,145,360,385
10017040020,基隆市,仁愛區,文安里,基隆市第01選區,鄭文婷,民主進步黨,223,177,208,recall_agree_votes,46,385,770,789
65000120027,新北市,瑞芳區,濓新里,新北市第12選區,賴品妤,民主進步黨,87,41,54,recall_agree_votes,46,95,250,257
10017010020,基隆市,中正區,碧砂里,基隆市第01選區,鄭文婷,民主進步黨,315,270,243,recall_agree_votes,45,513,1018,1046
65000120018,新北市,瑞芳區,基山里,新北市第12選區,賴品妤,民主進步黨,138,93,93,recall_agree_votes,45,186,383,390
10015020008,花蓮縣,鳳林鎮,北林里,花蓮縣第01選區,張美慧,民主進步黨,183,138,150,recall_agree_votes,45,288,470,481
65000250007,新北市,雙溪區,三貂里,新北市第12選區,賴品妤,民主進步黨,116,71,75,recall_agree_votes,45,146,303,337
65000270010,新北市,金山區,三界里,新北市第12選區,賴品妤,民主進步黨,209,164,124,recall_agree_votes,45,288,587,588
10009190021,雲林縣,口湖鄉,過港村,雲林縣第01選區,蘇治芬,民主進步黨,148,104,135,recall_agree_votes,44,239,537,566
10009180020,雲林縣,四湖鄉,飛東村,雲林縣第01選區,蘇治芬,民主進步黨,143,99,124,recall_agree_votes,44,223,481,486
10009180010,雲林縣,四湖鄉,三姓村,雲林縣第01選區,蘇治芬,民主進步黨,102,59,90,recall_agree_votes,43,149,321,331
10009060011,雲林縣,北港鎮,公舘里,雲林縣第01選區,蘇治芬,民主進步黨,182,139,132,recall_agree_votes,43,271,496,501
65000250005,新北市,雙溪區,三港里,新北市第12選區,賴品妤,民主進步黨,101,58,70,recall_agree_votes,43,128,295,315
10009060009,雲林縣,北港鎮,仁和里,雲林縣第01選區,蘇治芬,民主進步黨,150,107,124,recall_agree_votes,43,231,404,431
66000020008,臺中市,東區,樂成里,臺中市第06選區,江肇國,民主進步黨,810,768,709,recall_agree_votes,42,1477,2558,2307
10017040014,基隆市,仁愛區,育仁里,基隆市第01選區,鄭文婷,民主進步黨,213,171,135,recall_agree_votes,42,306,634,657
65000260002,新北市,貢寮區,吉林里,新北市第12選區,賴品妤,民主進步黨,134,92,69,recall_agree_votes,42,161,421,436
10017010019,基隆市,中正區,八斗里,基隆市第01選區,鄭文婷,民主進步黨,470,428,239,recall_agree_votes,42,667,1320,1369
10017020013,基隆市,七堵區,瑪東里,基隆市第01選區,鄭文婷,民主進步黨,106,66,77,recall_agree_votes,40,143,308,322
10009060027,雲林縣,北港鎮,水埔里,雲林縣第01選區,蘇治芬,民主進步黨,181,141,101,recall_agree_votes,40,242,423,450
65000250011,新北市,雙溪區,長源里,新北市第12選區,賴品妤,民主進步黨,109,69,58,recall_agree_votes,40,127,315,333
10017040011,基隆市,仁愛區,福仁里,基隆市第01選區,鄭文婷,民主進步黨,226,186,207,recall_agree_votes,40,393,675,706
65000240003,新北市,平溪區,白石里,新北市第12選區,賴品妤,民主進步黨,84,44,52,recall_agree_votes,40,96,206,212
10017020016,基隆市,七堵區,友二里,基隆市第01選區,鄭文婷,民主進步黨,154,115,107,recall_agree_votes,39,222,422,437
10009170019,雲林縣,元長鄉,內寮村,雲林縣第01選區,蘇治芬,民主進步黨,159,121,117,recall_agree_votes,38,238,520,540
65000120019,新北市,瑞芳區,永慶里,新北市第12選區,賴品妤,民主進步黨,115,78,82,recall_agree_votes,37,160,371,382
65000260004,新北市,貢寮區,龍崗里,新北市第12選區,賴品妤,民主進步黨,126,89,50,recall_agree_votes,37,139,354,369
10009060005,雲林縣,北港鎮,中和里,雲林縣第01選區,蘇治芬,民主進步黨,125,89,69,recall_agree_votes,36,158,298,319
65000100029,新北市,淡水區,民安里,新北市第01選區,何博文,民主進步黨,220,184,153,recall_agree_votes,36,337,579,595
10009200006,雲林縣,水林鄉,西井村,雲林縣第01選區,蘇治芬,民主進步黨,190,155,133,recall_agree_votes,35,288,548,571
10017040027,基隆市,仁愛區,文昌里,基隆市第01選區,鄭文婷,民主進步黨,272,237,174,recall_agree_votes,35,411,670,684
10009060007,雲林縣,北港鎮,共榮里,雲林縣第01選區,蘇治芬,民主進步黨,135,100,75,recall_agree_votes,35,175,340,346
65000120020,新北市,瑞芳區,崇文里,新北市第12選區,賴品妤,民主進步黨,87,53,67,recall_agree_votes,34,120,260,275
65000120032,新北市,瑞芳區,南雅里,新北市第12選區,賴品妤,民主進步黨,88,54,64,recall_agree_votes,34,118,243,257
65000240004,新北市,平溪區,石底里,新北市第12選區,賴品妤,民主進步黨,142,109,81,recall_agree_votes,33,190,373,372
65000270013,新北市,金山區,西湖里,新北市第12選區,賴品妤,民主進步黨,66,34,39,recall_agree_votes,32,73,162,162
65000240001,新北市,平溪區,薯榔里,新北市第12選區,賴品妤,民主進步黨,112,80,67,recall_agree_votes,32,147,314,340
65000120022,新北市,瑞芳區,頌德里,新北市第12選區,賴品妤,民主進步黨,91,60,76,recall_agree_votes,31,136,287,301
65000030054,新北市,中和區,灰磘里,新北市第08選區,吳崢,民主進步黨,201,171,198,recall_agree_votes,30,369,702,655
10014050006,臺東縣,鹿野鄉,鹿野村,臺東縣第01選區,賴坤成,民主進步黨,133,105,168,recall_agree_votes,28,273,583,616
10014050001,臺東縣,鹿野鄉,瑞和村,臺東縣第01選區,劉櫂豪,無黨籍及未經政黨推薦,69,41,77,recall_agree_votes,28,118,287,296
10014040011,臺東縣,卑南鄉,利嘉村,臺東縣第01選區,賴坤成,民主進步黨,98,70,108,recall_agree_votes,28,178,350,363
10017060009,基隆市,安樂區,安和里,基隆市第01選區,鄭文婷,民主進步黨,262,235,199,recall_agree_votes,27,434,777,795
10017040026,基隆市,仁愛區,同風里,基隆市第01選區,鄭文婷,民主進步黨,168,141,149,recall_agree_votes,27,290,539,559
10009060006,雲林縣,北港鎮,義民里,雲林縣第01選區,蘇治芬,民主進步黨,122,95,102,recall_agree_votes,27,197,334,355
10014060007,臺東縣,池上鄉,新興村,臺東縣第01選區,劉櫂豪,無黨籍及未經政黨推薦,140,113,173,recall_agree_votes,27,286,635,660
65000030041,新北市,中和區,橫路里,新北市第08選區,吳崢,民主進步黨,102,75,85,recall_agree_votes,27,160,285,296
10014030003,臺東縣,關山鎮,新福里,臺東縣第01選區,許瑞貴,無黨籍及未經政黨推薦,127,100,184,recall_agree_votes,27,284,572,588
68000020050,桃園市,中壢區,中榮里,桃園市第03選區,彭俊豪,民主進步黨,299,273,274,recall_agree_votes,26,547,977,788
10014050005,臺東縣,鹿野鄉,瑞隆村,臺東縣第01選區,劉櫂豪,無黨籍及未經政黨推薦,110,85,156,recall_agree_votes,25,241,559,579
10017010005,基隆市,中正區,港通里,基隆市第01選區,鄭文婷,民主進步黨,361,336,379,recall_agree_votes,25,715,1197,1185
10014070006,臺東縣,東河鄉,興昌村,臺東縣第01選區,劉櫂豪,無黨籍及未經政黨推薦,150,125,127,recall_agree_votes,25,252,489,513
10014040002,臺東縣,卑南鄉,利吉村,臺東縣第01選區,賴坤成,民主進步黨,66,42,64,recall_agree_votes,24,106,228,230
65000110004,新北市,汐止區,信望里,新北市第12選區,賴品妤,民主進步黨,106,82,80,recall_agree_votes,24,162,287,300
10017020014,基隆市,七堵區,瑪西里,基隆市第01選區,鄭文婷,民主進步黨,94,70,84,recall_agree_votes,24,154,297,315
65000120015,新北市,瑞芳區,光復里,新北市第12選區,賴品妤,民主進步黨,83,59,59,recall_agree_votes,24,118,225,237
10014050002,臺東縣,鹿野鄉,瑞豐村,臺東縣第01選區,賴坤成,民主進步黨,215,192,142,recall_agree_votes,23,334,742,765
10017020012,基隆市,七堵區,瑪南里,基隆市第01選區,鄭文婷,民主進步黨,113,92,81,recall_agree_votes,21,173,357,385
10014020002,臺東縣,成功鎮,忠孝里,臺東縣第01選區,賴坤成,民主進步黨,65,44,70,recall_agree_votes,21,114,291,316
10014040013,臺東縣,卑南鄉,溫泉村,臺東縣第01選區,賴坤成,民主進步黨,233,212,230,recall_agree_votes,21,442,961,931
10014040004,臺東縣,卑南鄉,富源村,臺東縣第01選區,賴坤成,民主進步黨,83,62,64,recall_agree_votes,21,126,287,296
10014070004,臺東縣,東河鄉,尚德村,臺東縣第01選區,劉櫂豪,無黨籍及未經政黨推薦,40,20,29,recall_agree_votes,20,49,143,158
10017040028,基隆市,仁愛區,新店里,基隆市第01選區,鄭文婷,民主進步黨,173,154,148,recall_agree_votes,19,302,500,531
10014050003,臺東縣,鹿野鄉,瑞源村,臺東縣第01選區,劉櫂豪,無黨籍及未經政黨推薦,107,88,123,recall_agree_votes,19,211,447,467
10017040008,基隆市,仁愛區,玉田里,基隆市第01選區,鄭文婷,民主進步黨,239,222,226,recall_agree_votes,17,448,814,850
65000240010,新北市,平溪區,平湖里,新北市第12選區,賴品妤,民主進步黨,57,40,27,recall_agree_votes,17,67,139,150
65000120025,新北市,瑞芳區,銅山里,新北市第12選區,賴品妤,民主進步黨,60,44,38,recall_agree_votes,16,82,167,178
10014080006,臺東縣,長濱鄉,寧埔村,臺東縣第01選區,劉櫂豪,無黨籍及未經政黨推薦,47,31,57,recall_agree_votes,16,88,232,239
10015060009,花蓮縣,壽豐鄉,池南村,花蓮縣第01選區,張美慧,民主進步黨,125,110,120,recall_agree_votes,15,230,371,379
10014030006,臺東縣,關山鎮,電光里,臺東縣第01選區,許瑞貴,無黨籍及未經政黨推薦,30,15,39,recall_agree_votes,15,54,159,181
10017030011,基隆市,暖暖區,八中里,基隆市第01選區,鄭文婷,民主進步黨,99,85,100,recall_agree_votes,14,185,368,381
10017010021,基隆市,中正區,長潭里,基隆市第01選區,鄭文婷,民主進步黨,140,126,97,recall_agree_votes,14,223,388,403
10017040018,基隆市,仁愛區,曲水里,基隆市第01選區,鄭文婷,民主進步黨,228,214,193,recall_agree_votes,14,407,722,715
10014040001,臺東縣,卑南鄉,嘉豐村,臺東縣第01選區,賴坤成,民主進步黨,38,24,27,recall_agree_votes,14,51,135,152
10017040016,基隆市,仁愛區,龍門里,基隆市第01選區,鄭文婷,民主進步黨,231,218,209,recall_agree_votes,13,427,738,744
10017050003,基隆市,中山區,安平里,基隆市第01選區,鄭文婷,民主進步黨,204,192,201,recall_agree_votes,12,393,659,708
68000130006,桃園市,復興區,三光里,桃園市第06選區,趙正宇,無黨籍及未經政黨推薦,13,1,11,recall_agree_votes,12,12,57,58
10017050016,基隆市,中山區,西榮里,基隆市第01選區,鄭文婷,民主進步黨,172,160,162,recall_agree_votes,12,322,595,627
10014060008,臺東縣,池上鄉,萬安村,臺東縣第01選區,賴坤成,民主進步黨,68,58,58,recall_agree_votes,10,116,254,278
10017060005,基隆市,安樂區,慈仁里,基隆市第01選區,鄭文婷,民主進步黨,249,240,170,recall_agree_votes,9,410,783,805
10017040012,基隆市,仁愛區,誠仁里,基隆市第01選區,鄭文婷,民主進步黨,238,229,226,recall_agree_votes,9,455,818,831
10014080005,臺東縣,長濱鄉,竹湖村,臺東縣第01選區,劉櫂豪,無黨籍及未經政黨推薦,56,47,42,recall_agree_votes,9,89,263,274
10014120003,臺東縣,海端鄉,利稻村,臺東縣第01選區,賴坤成,民主進步黨,9,0,6,recall_agree_votes,9,6,20,21
10014160004,臺東縣,蘭嶼鄉,椰油村,臺東縣第01選區,賴坤成,民主進步黨,35,27,43,recall_agree_votes,8,70,256,258
10017030009,基隆市,暖暖區,暖東里,基隆市第01選區,王醒之,無黨籍及未經政黨推薦,82,74,100,recall_agree_votes,8,174,359,377
10015050008,花蓮縣,吉安鄉,南華村,花蓮縣第01選區,張美慧,民主進步黨,362,354,341,recall_agree_votes,8,695,1067,1076
10014070007,臺東縣,東河鄉,都蘭村,臺東縣第01選區,劉櫂豪,無黨籍及未經政黨推薦,234,227,279,recall_agree_votes,7,506,1041,1053
10015090011,花蓮縣,瑞穗鄉,富興村,花蓮縣第01選區,張美慧,民主進步黨,95,88,89,recall_agree_votes,7,177,317,330
10015080003,花蓮縣,豐濱鄉,磯崎村,花蓮縣第01選區,張美慧,民主進步黨,16,9,12,recall_agree_votes,7,21,55,59
10014020001,臺東縣,成功鎮,博愛里,臺東縣第01選區,劉櫂豪,無黨籍及未經政黨推薦,17,11,17,recall_agree_votes,6,28,58,57
10014090001,臺東縣,太麻里鄉,美和村,臺東縣第01選區,賴坤成,民主進步黨,204,199,232,recall_agree_votes,5,431,864,879
10014090004,臺東縣,太麻里鄉,北里村,臺東縣第01選區,劉櫂豪,無黨籍及未經政黨推薦,72,67,75,recall_agree_votes,5,142,290,312
10017060010,基隆市,安樂區,樂一里,基隆市第01選區,鄭文婷,民主進步黨,167,162,158,recall_agree_votes,5,320,591,621
10014040005,臺東縣,卑南鄉,明峰村,臺東縣第01選區,賴坤成,民主進步黨,171,166,209,recall_agree_votes,5,375,782,808
10014130004,臺東縣,延平鄉,鸞山村,臺東縣第01選區,賴坤成,民主進步黨,14,9,13,recall_agree_votes,5,22,65,66
10014150002,臺東縣,達仁鄉,土坂村,臺東縣第01選區,劉櫂豪,無黨籍及未經政黨推薦,6,1,2,recall_agree_votes,5,3,16,16
10014130005,臺東縣,延平鄉,桃源村,臺東縣第01選區,賴坤成,民主進步黨,21,16,25,recall_agree_votes,5,41,106,104
10015130003,花蓮縣,卓溪鄉,太平村,花蓮縣第01選區,張美慧,民主進步黨,5,1,5,recall_agree_votes,4,6,17,17
10014120005,臺東縣,海端鄉,崁頂村,臺東縣第01選區,許瑞貴,無黨籍及未經政黨推薦,6,2,9,recall_agree_votes,4,11,24,23
10014060010,臺東縣,池上鄉,振興村,臺東縣第01選區,劉櫂豪,無黨籍及未經政黨推薦,22,18,29,recall_agree_votes,4,47,123,126
10014150001,臺東縣,達仁鄉,台坂村,臺東縣第01選區,劉櫂豪,無黨籍及未經政黨推薦,4,0,4,recall_agree_votes,4,4,14,12
10014020007,臺東縣,成功鎮,和平里,臺東縣第01選區,劉櫂豪,無黨籍及未經政黨推薦,28,25,24,recall_agree_votes,3,49,128,137
10014050007,臺東縣,鹿野鄉,龍田村,臺東縣第01選區,劉櫂豪,無黨籍及未經政黨推薦,216,214,231,recall_agree_votes,2,445,912,933
10014120002,臺東縣,海端鄉,霧鹿村,臺東縣第01選區,賴坤成,民主進步黨,5,6,3,recall_agree_votes,-1,9,17,19
10014060004,臺東縣,池上鄉,大埔村,臺東縣第01選區,賴坤成,民主進步黨,71,72,98,recall_agree_votes,-1,170,350,367
10017030007,基隆市,暖暖區,暖同里,基隆市第01選區,王醒之,無黨籍及未經政黨推薦,663,664,607,recall_agree_votes,-1,1271,2513,2461
10015080002,花蓮縣,豐濱鄉,新社村,花蓮縣第01選區,張美慧,民主進步黨,20,22,12,recall_agree_votes,-2,34,70,75
10015080004,花蓮縣,豐濱鄉,港口村,花蓮縣第01選區,張美慧,民主進步黨,44,48,17,recall_agree_votes,-4,65,107,112
10014070005,臺東縣,東河鄉,隆昌村,臺東縣第01選區,劉櫂豪,無黨籍及未經政黨推薦,38,42,35,recall_agree_votes,-4,77,176,191
10014160002,臺東縣,蘭嶼鄉,朗島村,臺東縣第01選區,賴坤成,民主進步黨,8,12,8,recall_agree_votes,-4,20,85,79
10017030002,基隆市,暖暖區,八堵里,基隆市第01選區,鄭文婷,民主進步黨,137,146,157,recall_agree_votes,-9,303,564,562
10014160001,臺東縣,蘭嶼鄉,東清村,臺東縣第01選區,劉櫂豪,無黨籍及未經政黨推薦,24,33,16,recall_agree_votes,-9,49,173,181
10017030003,基隆市,暖暖區,八南里,基隆市第01選區,鄭文婷,民主進步黨,171,181,185,recall_agree_votes,-10,366,733,754
10015040002,花蓮縣,新城鄉,順安村,花蓮縣第01選區,張美慧,民主進步黨,234,248,165,recall_agree_votes,-14,413,696,700
10014090003,臺東縣,太麻里鄉,華源村,臺東縣第01選區,劉櫂豪,無黨籍及未經政黨推薦,127,146,113,recall_agree_votes,-19,259,545,562
10018010006,新竹市,東區,榮光里,新竹市第01選區,林志潔,民主進步黨,89,151,119,recall_agree_votes,-62,270,505,275
10018020025,新竹市,北區,舊港里,新竹市第01選區,林志潔,民主進步黨,146,268,365,recall_agree_votes,-122,633,1064,546
10018010012,新竹市,東區,中正里,新竹市第01選區,林志潔,民主進步黨,140,263,317,recall_agree_votes,-123,580,1049,527
10018010004,新竹市,東區,關帝里,新竹市第01選區,林志潔,民主進步黨,150,276,224,recall_agree_votes,-126,500,871,448
10018020004,新竹市,北區,中央里,新竹市第01選區,林志潔,民主進步黨,152,280,197,recall_agree_votes,-128,477,789,445
10018020006,新竹市,北區,石坊里,新竹市第01選區,林志潔,民主進步黨,148,302,298,recall_agree_votes,-154,600,1030,493
10018020001,新竹市,北區,西門里,新竹市第01選區,林志潔,民主進步黨,148,313,320,recall_agree_votes,-165,633,1113,551
10018010007,新竹市,東區,成功里,新竹市第01選區,林志潔,民主進步黨,173,340,268,recall_agree_votes,-167,608,1015,542
10018030018,新竹市,香山區,大湖里,新竹市第01選區,林志潔,民主進步黨,238,410,537,recall_agree_votes,-172,947,1712,846
10018010001,新竹市,東區,南門里,新竹市第01選區,林志潔,民主進步黨,210,386,402,recall_agree_votes,-176,788,1327,681
10018020010,新竹市,北區,大同里,新竹市第01選區,林志潔,民主進步黨,205,407,485,recall_agree_votes,-202,892,1433,744
10018010009,新竹市,東區,竹蓮里,新竹市第01選區,林志潔,民主進步黨,194,399,389,recall_agree_votes,-205,788,1279,679
10018020020,新竹市,北區,古賢里,新竹市第01選區,林志潔,民主進步黨,257,466,479,recall_agree_votes,-209,945,1614,796
10018020003,新竹市,北區,潛園里,新竹市第01選區,林志潔,民主進步黨,239,451,408,recall_agree_votes,-212,859,1355,700
10018020002,新竹市,北區,仁德里,新竹市第01選區,林志潔,民主進步黨,183,396,384,recall_agree_votes,-213,780,1368,661
10018030023,新竹市,香山區,南港里,新竹市第01選區,林志潔,民主進步黨,254,475,429,recall_agree_votes,-221,904,1549,728
10018010010,新竹市,東區,寺前里,新竹市第01選區,林志潔,民主進步黨,201,441,492,recall_agree_votes,-240,933,1525,732
10018010003,新竹市,東區,南市里,新竹市第01選區,林志潔,民主進步黨,267,521,421,recall_agree_votes,-254,942,1585,817
68000050011,桃園市,蘆竹區,山鼻里,桃園市第01選區,鄭運鵬,民主進步黨,654,919,1031,recall_agree_votes,-265,1950,3703,1979
10018020011,新竹市,北區,中山里,新竹市第01選區,林志潔,民主進步黨,276,548,494,recall_agree_votes,-272,1042,1728,854
10018020009,新竹市,北區,中興里,新竹市第01選區,林志潔,民主進步黨,246,520,579,recall_agree_votes,-274,1099,1747,850
68000010038,桃園市,桃園區,青溪里,桃園市第01選區,鄭運鵬,民主進步黨,1701,1982,2204,recall_agree_votes,-281,4186,7648,5062
10018030014,新竹市,香山區,美山里,新竹市第01選區,林志潔,民主進步黨,301,593,588,recall_agree_votes,-292,1181,2101,1083
10018020008,新竹市,北區,北門里,新竹市第01選區,林志潔,民主進步黨,276,596,517,recall_agree_votes,-320,1113,1904,947
10018020007,新竹市,北區,興南里,新竹市第01選區,林志潔,民主進步黨,388,711,751,recall_agree_votes,-323,1462,2539,1277
10018030022,新竹市,香山區,鹽水里,新竹市第01選區,林志潔,民主進步黨,385,713,890,recall_agree_votes,-328,1603,2878,1417
10018020005,新竹市,北區,崇禮里,新竹市第01選區,林志潔,民主進步黨,317,660,574,recall_agree_votes,-343,1234,2038,1023
10018010015,新竹市,東區,南大里,新竹市第01選區,林志潔,民主進步黨,362,720,795,recall_agree_votes,-358,1515,2531,1310
10018020012,新竹市,北區,長和里,新竹市第01選區,林志潔,民主進步黨,376,745,783,recall_agree_votes,-369,1528,2682,1333
10018020013,新竹市,北區,新民里,新竹市第01選區,林志潔,民主進步黨,401,770,979,recall_agree_votes,-369,1749,3020,1539
10018020044,新竹市,北區,台溪里,新竹市第01選區,林志潔,民主進步黨,354,771,947,recall_agree_votes,-417,1718,3155,1459
10018030015,新竹市,香山區,朝山里,新竹市第01選區,林志潔,民主進步黨,589,1124,1385,recall_agree_votes,-535,2509,4365,2089
10018020027,新竹市,北區,港北里,新竹市第01選區,林志潔,民主進步黨,568,1120,1346,recall_agree_votes,-552,2466,4512,2159
10018030003,新竹市,香山區,虎林里,新竹市第01選區,林志潔,民主進步黨,621,1173,1391,recall_agree_votes,-552,2564,4268,2143
10018030004,新竹市,香山區,浸水里,新竹市第01選區,林志潔,民主進步黨,723,1295,1339,recall_agree_votes,-572,2634,4612,2351
10018020030,新竹市,北區,客雅里,新竹市第01選區,林志潔,民主進步黨,456,1038,1173,recall_agree_votes,-582,2211,3686,1684
10018030005,新竹市,香山區,樹下里,新竹市第01選區,林志潔,民主進步黨,746,1335,1073,recall_agree_votes,-589,2408,4022,2023
10018010038,新竹市,東區,前溪里,新竹市第01選區,林志潔,民主進步黨,699,1305,1604,recall_agree_votes,-606,2909,5113,2611
10018020033,新竹市,北區,西雅里,新竹市第01選區,林志潔,民主進步黨,798,1510,1740,recall_agree_votes,-712,3250,5411,2733
10018030007,新竹市,香山區,中埔里,新竹市第01選區,林志潔,民主進步黨,790,1504,1804,recall_agree_votes,-714,3308,5423,2769
10018020018,新竹市,北區,士林里,新竹市第01選區,林志潔,民主進步黨,532,1260,1467,recall_agree_votes,-728,2727,4450,1914
10018030001,新竹市,香山區,港南里,新竹市第01選區,林志潔,民主進步黨,842,1575,1641,recall_agree_votes,-733,3216,5517,2675
10018020026,新竹市,北區,康樂里,新竹市第01選區,林志潔,民主進步黨,819,1606,2132,recall_agree_votes,-787,3738,6423,3118
10018010014,新竹市,東區,頂竹里,新竹市第01選區,林志潔,民主進步黨,694,1482,1702,recall_agree_votes,-788,3184,5218,2673
10018030013,新竹市,香山區,大庄里,新竹市第01選區,林志潔,民主進步黨,819,1622,1721,recall_agree_votes,-803,3343,5621,2765
10018010029,新竹市,東區,新興里,新竹市第01選區,林志潔,民主進步黨,802,1618,1976,recall_agree_votes,-816,3594,5976,2993
10018020031,新竹市,北區,育英里,新竹市第01選區,林志潔,民主進步黨,890,1709,2035,recall_agree_votes,-819,3744,6490,3270
10018010023,新竹市,東區,光復里,新竹市第01選區,林志潔,民主進步黨,710,1531,1816,recall_agree_votes,-821,3347,5559,2756
10018010039,新竹市,東區,水源里,新竹市第01選區,林志潔,民主進步黨,916,1758,1950,recall_agree_votes,-842,3708,6139,3129
10018030006,新竹市,香山區,埔前里,新竹市第01選區,林志潔,民主進步黨,859,1780,1855,recall_agree_votes,-921,3635,6119,3019
10018010049,新竹市,東區,新光里,新竹市第01選區,林志潔,民主進步黨,823,1756,2267,recall_agree_votes,-933,4023,6757,3255
10018020029,新竹市,北區,海濱里,新竹市第01選區,林志潔,民主進步黨,1002,1974,3023,recall_agree_votes,-972,4997,9260,4420
10018030012,新竹市,香山區,香山里,新竹市第01選區,林志潔,民主進步黨,1077,2066,2903,recall_agree_votes,-989,4969,8469,4179
10018020038,新竹市,北區,新雅里,新竹市第01選區,林志潔,民主進步黨,1157,2275,2693,recall_agree_votes,-1118,4968,8651,4368
10018020014,新竹市,北區,民富里,新竹市第01選區,林志潔,民主進步黨,1207,2353,2686,recall_agree_votes,-1146,5039,8926,4523
10018010054,新竹市,東區,關新里,新竹市第01選區,林志潔,民主進步黨,914,2062,2564,recall_agree_votes,-1148,4626,7925,3985
10018020024,新竹市,北區,南寮里,新竹市第01選區,林志潔,民主進步黨,1375,2534,3497,recall_agree_votes,-1159,6031,11543,5590
10018010020,新竹市,東區,三民里,新竹市第01選區,林志潔,民主進步黨,1141,2360,3005,recall_agree_votes,-1219,5365,9040,4443
10018030002,新竹市,香山區,虎山里,新竹市第01選區,林志潔,民主進步黨,1438,2725,3011,recall_agree_votes,-1287,5736,10428,5247
10018020034,新竹市,北區,南勢里,新竹市第01選區,林志潔,民主進步黨,1325,2625,2519,recall_agree_votes,-1300,5144,8373,4151
10018020043,新竹市,北區,金雅里,新竹市第01選區,林志潔,民主進步黨,868,2195,2856,recall_agree_votes,-1327,5051,7830,3528
10018030009,新竹市,香山區,頂埔里,新竹市第01選區,林志潔,民主進步黨,1169,2603,3141,recall_agree_votes,-1434,5744,9851,4874
10017050004,基隆市,中山區,中山里,基隆市第01選區,鄭文婷,民主進步黨,280,1824,1805,recall_agree_votes,-1544,3629,6880,908
10018020037,新竹市,北區,磐石里,新竹市第01選區,林志潔,民主進步黨,1320,2913,3293,recall_agree_votes,-1593,6206,10159,5095
10018010041,新竹市,東區,埔頂里,新竹市第01選區,柯美蘭,無黨籍及未經政黨推薦,1560,3479,5261,recall_agree_votes,-1919,8740,15488,6890
10018010022,新竹市,東區,東勢里,新竹市第01選區,林志潔,民主進步黨,880,2815,3455,recall_agree_votes,-1935,6270,10281,3827
10018010005,新竹市,東區,東門里,新竹市第01選區,林志潔,民主進步黨,162,2564,2340,recall_agree_votes,-2402,4904,8055,506
